04030,        47,        25,        22,                   30,                     16,                         1
01330,       386,       182,       204,                  307,                     53,                        26
00391,        81,        42,        39,                   75,                      4,                         2
08435,       147,        77,        70,                  129,                      9,                         9
00965,       110,        53,        57,                   94,                     11,                         5
04715,       221,       100,       121,                  179,                     32,                        10
01268,        44,        21,        23,                   43,                      1,                         0
00757,         9,         4,         5,                    9,                      0,                         0
08295,        97,        44,        53,                   92,                      3,                         2
02975,        15,         9,         6,                   12,                      2,                         1
04905,       159,        85,        74,                  155,                      4,                         0
07770,        52,        26,        26,                   52,                      0,                         0
05150,       155,        71,        84,                  124,                     28,                         3
00441,       456,       227,       229,                  404,                     29,                        23
04720,        91,        47,        44,                   82,                      4,                         5
04445,       627,       308,       319,                  563,                     16,                        48
01645,        35,        15,        20,                   31,                      0,                         4
09976,       106,        52,        54,                  105,                      1,                         0
07515,       144,        66,        78,                  142,                      0,                         2
06450,        52,        26,        26,                   36,                     13,                         3
06485,       166,        85,        81,                  162,                      4,                         0
05110,        13,         5,         8,                   11,                      2,                         0
06930,       188,        99,        89,                  144,                      9,                        35
00333,         9,         3,         6,                    9,                      0,                         0
00984,        58,        24,        34,                   53,                      1,                         4
04775,       151,        79,        72,                  147,                      0,                         4
01390,       116,        56,        60,                  114,                      0,                         2
05555,       189,        91,        98,                  166,                      9,                        14
07985,        88,        47,        41,                   88,                      0,                         0
04190,       279,       121,       158,                  266,                      7,                         6
05245,       388,       186,       202,                  369,                      1,                        18
09005,       199,        98,       101,                  182,                      0,                        17
00450,        36,        17,        19,                   33,                      1,                         2
06135,       114,        48,        66,                  104,                      3,                         7
00698,        43,        18,        25,                   38,                      4,                         1
03735,        58,        32,        26,                   53,                      4,                         1
01260,        56,        32,        24,                   55,                      1,                         0
07250,        69,        35,        34,                   68,                      0,                         1
04590,        40,        17,        23,                   39,                      0,                         1
04345,        81,        40,        41,                   81,                      0,                         0
08695,        72,        34,        38,                   50,                     21,                         1
00281,        24,        11,        13,                   23,                      0,                         1
03980,       154,        71,        83,                  136,                      0,                        18
02870,       212,       101,       111,                  156,                     10,                        46
00883,        27,        13,        14,                   27,                      0,                         0
00721,         5,         3,         2,                    4,                      0,                         1
07025,       246,       123,       123,                  183,                      5,                        58
00535,       261,       114,       147,                  193,                     34,                        34
07660,       167,        83,        84,                  142,                      2,                        23
05255,        34,        18,        16,                   33,                      0,                         1
05030,        55,        24,        31,                   49,                      0,                         6
02770,        35,        20,        15,                   34,                      0,                         1
07040,       116,        59,        57,                  111,                      2,                         3
01565,       138,        69,        69,                  130,                      2,                         6
00358,        25,        10,        15,                   23,                      0,                         2
03605,        98,        55,        43,                   97,                      0,                         1
02875,       131,        59,        72,                  105,                     19,                         7
02430,        69,        29,        40,                   60,                      8,                         1
07535,       125,        57,        68,                  119,                      1,                         5
04620,        80,        48,        32,                   72,                      6,                         2
01650,        19,        10,         9,                   19,                      0,                         0
05010,       477,       243,       234,                  467,                      2,                         8
00344,       239,       113,       126,                  184,                     24,                        31
08895,        92,        41,        51,                   84,                      0,                         8
09964,       215,        97,       118,                  203,                      7,                         5
04220,        39,        25,        14,                   39,                      0,                         0
01085,        40,        18,        22,                   40,                      0,                         0
09175,       245,       124,       121,                  152,                     53,                        40
04915,        54,        24,        30,                   53,                      0,                         1
00253,        21,        10,        11,                   20,                      1,                         0
00446,        50,        23,        27,                   50,                      0,                         0
03245,       403,       183,       220,                  372,                     18,                        13
00505,        41,        17,        24,                   30,                      4,                         7
02470,        11,         7,         4,                   10,                      0,                         1
07295,       101,        52,        49,                   88,                     10,                         3
06055,       344,       180,       164,                  344,                      0,                         0
09150,         9,         3,         6,                    8,                      0,                         1
00279,        45,        24,        21,                   43,                      0,                         2
04872,       115,        57,        58,                  108,                      5,                         2
00143,        16,        10,         6,                   16,                      0,                         0
05890,        14,         8,         6,                   14,                      0,                         0
01825,        23,        10,        13,                   23,                      0,                         0
01172,        28,        15,        13,                   25,                      3,                         0
03395,        66,        30,        36,                   66,                      0,                         0
04511,        30,        18,        12,                   30,                      0,                         0
00977,         2,         0,         2,                    2,                      0,                         0
01975,        67,        34,        33,                   61,                      5,                         1
07010,       146,        73,        73,                  131,                      9,                         6
00286,        19,         8,        11,                   19,                      0,                         0
03185,       347,       175,       172,                  343,                      2,                         2
06580,        19,         9,        10,                   17,                      2,                         0
00035,       241,       124,       117,                  209,                      3,                        29
01985,        36,        20,        16,                   36,                      0,                         0
00997,        92,        48,        44,                   89,                      2,                         1
03780,        11,         6,         5,                   11,                      0,                         0
08610,       162,        80,        82,                  154,                      6,                         2
00470,        26,        12,        14,                   24,                      2,                         0
02482,        65,        33,        32,                   43,                     17,                         5
08680,       119,        52,        67,                  111,                      6,                         2
00696,        11,         7,         4,                   11,                      0,                         0
00296,        19,        10,         9,                   19,                      0,                         0
01655,       144,        73,        71,                  140,                      0,                         4
06115,       130,        61,        69,                  120,                      6,                         4
05905,        16,         8,         8,                   15,                      0,                         1
03295,       213,       110,       103,                  168,                      6,                        39
00360,       308,       137,       171,                  277,                      2,                        29
04060,        21,         8,        13,                   17,                      4,                         0
01970,         2,         1,         1,                    2,                      0,                         0
02660,        63,        35,        28,                   60,                      0,                         3
09192,         3,         3,         0,                    3,                      0,                         0
05580,       108,        54,        54,                  102,                      1,                         5
05490,        30,        10,        20,                   30,                      0,                         0
00403,        47,        22,        25,                   46,                      0,                         1
01294,        24,        11,        13,                   23,                      0,                         1
03565,        12,         7,         5,                   12,                      0,                         0
06765,        29,        13,        16,                   29,                      0,                         0
03095,         1,         0,         1,                    1,                      0,                         0
00934,        48,        22,        26,                   44,                      2,                         2
03925,       106,        52,        54,                  103,                      0,                         3
07935,         9,         3,         6,                    9,                      0,                         0
04240,        54,        25,        29,                   52,                      2,                         0
00315,        41,        18,        23,                   41,                      0,                         0
00712,         9,         5,         4,                    9,                      0,                         0
00709,        31,        19,        12,                   31,                      0,                         0
01207,         2,         1,         1,                    2,                      0,                         0
01960,       161,        87,        74,                  102,                      5,                        54
08405,        12,         8,         4,                    7,                      5,                         0
02645,        21,         6,        15,                   20,                      0,                         1
08670,        39,        22,        17,                   32,                      0,                         7
06910,       155,        79,        76,                  137,                      1,                        17
01290,        14,         7,         7,                   14,                      0,                         0
02790,        22,        11,        11,                   22,                      0,                         0
06770,        39,        18,        21,                   36,                      2,                         1
04276,       150,        75,        75,                  147,                      2,                         1
06465,        36,        16,        20,                   36,                      0,                         0
00951,        14,         9,         5,                   14,                      0,                         0
01295,        15,         6,         9,                   15,                      0,                         0
01178,         7,         2,         5,                    7,                      0,                         0
00415,        63,        32,        31,                   53,                      3,                         7
09050,       211,       103,       108,                  182,                      5,                        24
05690,       458,       225,       233,                  438,                      0,                        20
04765,        76,        37,        39,                   64,                      0,                        12
02785,        47,        25,        22,                   44,                      0,                         3
00001,        26,         8,        18,                   25,                      0,                         1
07365,       190,        98,        92,                  184,                      0,                         6
07600,        23,        10,        13,                   23,                      0,                         0
00630,        63,        35,        28,                   56,                      0,                         7
08225,        57,        27,        30,                   50,                      0,                         7
01246,         9,         5,         4,                    9,                      0,                         0
00077,        26,         9,        17,                   24,                      1,                         1
05485,        29,        17,        12,                   28,                      0,                         1
06040,        19,         8,        11,                   18,                      1,                         0
00031,        49,        22,        27,                   47,                      0,                         2
00985,        45,        20,        25,                   45,                      0,                         0
09020,         2,         2,         0,                    2,                      0,                         0
04015,        20,        14,         6,                   20,                      0,                         0
00417,        16,         7,         9,                   16,                      0,                         0
00857,         7,         5,         2,                    7,                      0,                         0
00973,        72,        40,        32,                   72,                      0,                         0
00017,        31,        13,        18,                   31,                      0,                         0
05605,        12,         5,         7,                   12,                      0,                         0
03535,        65,        32,        33,                   62,                      0,                         3
05305,        63,        34,        29,                   59,                      1,                         3
04270,        68,        33,        35,                   68,                      0,                         0
00620,         3,         0,         3,                    3,                      0,                         0
01665,         3,         2,         1,                    3,                      0,                         0
00399,       160,        81,        79,                  150,                      8,                         2
01175,        81,        43,        38,                   77,                      0,                         4
05870,        31,        15,        16,                   26,                      1,                         4
03610,        12,         6,         6,                   12,                      0,                         0
01234,         9,         4,         5,                    9,                      0,                         0
01241,        26,        14,        12,                   23,                      1,                         2
00166,        34,        18,        16,                   34,                      0,                         0
04940,        51,        25,        26,                   49,                      0,                         2
00110,        21,         6,        15,                   20,                      0,                         1
01820,        76,        42,        34,                   75,                      0,                         1
00080,        21,         9,        12,                   21,                      0,                         0
04390,        20,        10,        10,                   20,                      0,                         0
08340,        33,        18,        15,                   33,                      0,                         0
04610,        31,        16,        15,                   28,                      0,                         3
07150,        10,         6,         4,                   10,                      0,                         0
00463,         3,         2,         1,                    3,                      0,                         0
00469,         4,         2,         2,                    4,                      0,                         0
04150,        11,         5,         6,                   10,                      0,                         1
00453,        13,         5,         8,                   13,                      0,                         0
00020,         3,         0,         3,                    3,                      0,                         0
00502,         5,         3,         2,                    5,                      0,                         0
00995,        16,         9,         7,                   16,                      0,                         0
00364,        15,         9,         6,                   14,                      1,                         0
02135,        17,        10,         7,                   17,                      0,                         0
01220,        16,         8,         8,                   16,                      0,                         0
03515,        15,         7,         8,                   15,                      0,                         0
00136,         8,         5,         3,                    8,                      0,                         0
02030,        17,         6,        11,                   17,                      0,                         0
01142,         5,         1,         4,                    1,                      0,                         4
05450,         8,         5,         3,                    8,                      0,                         0
00548,         5,         2,         3,                    5,                      0,                         0
07626,        15,         9,         6,                   15,                      0,                         0
00589,         6,         4,         2,                    5,                      0,                         1
05825,        94,        44,        50,                   93,                      1,                         0
00617,        13,         7,         6,                   13,                      0,                         0
05345,         8,         2,         6,                    8,                      0,                         0
00633,        12,         5,         7,                   12,                      0,                         0
00598,         1,         1,         0,                    1,                      0,                         0
00599,         2,         2,         0,                    2,                      0,                         0
00606,        19,         9,        10,                   19,                      0,                         0
04275,         4,         3,         1,                    4,                      0,                         0
00831,         4,         2,         2,                    4,                      0,                         0
00782,         6,         3,         3,                    6,                      0,                         0
00099,         4,         3,         1,                    4,                      0,                         0
00761,         3,         1,         2,                    3,                      0,                         0
09180,        30,        16,        14,                   30,                      0,                         0
00003,        29,        15,        14,                   29,                      0,                         0
00145,         5,         3,         2,                    5,                      0,                         0
08595,        12,         3,         9,                   12,                      0,                         0
01307,         3,         1,         2,                    3,                      0,                         0
08000,        94,        48,        46,                   68,                     19,                         7
01317,         4,         0,         4,                    4,                      0,                         0
06035,        50,        23,        27,                   49,                      1,                         0
01166,        11,         6,         5,                   11,                      0,                         0
04365,         7,         3,         4,                    7,                      0,                         0
00802,        13,         5,         8,                   13,                      0,                         0
04670,        16,         9,         7,                    8,                      0,                         8
07880,        41,        21,        20,                   41,                      0,                         0
00657,         2,         1,         1,                    2,                      0,                         0
00772,         2,         1,         1,                    2,                      0,                         0
02410,         5,         3,         2,                    5,                      0,                         0
01810,        25,        16,         9,                   25,                      0,                         0
00177,         5,         3,         2,                    5,                      0,                         0
06150,         3,         2,         1,                    3,                      0,                         0
03215,         5,         2,         3,                    3,                      2,                         0
00140,         5,         3,         2,                    5,                      0,                         0
02020,        11,         8,         3,                   10,                      1,                         0
08580,        13,         8,         5,                   13,                      0,                         0
01270,         7,         1,         6,                    7,                      0,                         0
05055,        26,        13,        13,                   26,                      0,                         0
05680,        13,         6,         7,                   11,                      0,                         2
04140,         4,         1,         3,                    4,                      0,                         0
00682,        12,         7,         5,                   12,                      0,                         0
01047,         2,         1,         1,                    2,                      0,                         0
01200,         4,         2,         2,                    4,                      0,                         0
05120,         3,         3,         0,                    2,                      1,                         0
01263,        16,         5,        11,                   16,                      0,                         0
00996,         5,         3,         2,                    5,                      0,                         0
09095,         1,         1,         0,                    1,                      0,                         0
01026,         1,         0,         1,                    0,                      0,                         1
02035,         3,         1,         2,                    3,                      0,                         0
05105,         4,         2,         2,                    2,                      2,                         0
00218,         1,         0,         1,                    1,                      0,                         0
01351,         2,         1,         1,                    2,                      0,                         0
01214,         5,         2,         3,                    4,                      0,                         1
03950,         3,         1,         2,                    3,                      0,                         0
01278,         2,         1,         1,                    2,                      0,                         0
05973,         4,         2,         2,                    4,                      0,                         0
01369,         0,         0,         0,                    0,                      0,                         0
01196,         0,         0,         0,                    0,                      0,                         0
01389,         0,         0,         0,                    0,                      0,                         0
01325,         0,         0,         0,                    0,                      0,                         0
00163,         0,         0,         0,                    0,                      0,                         0
01387,         0,         0,         0,                    0,                      0,                         0
01339,         0,         0,         0,                    0,                      0,                         0
00499,         0,         0,         0,                    0,                      0,                         0
00944,         0,         0,         0,                    0,                      0,                         0
00452,         0,         0,         0,                    0,                      0,                         0
00472,         0,         0,         0,                    0,                      0,                         0
00482,         0,         0,         0,                    0,                      0,                         0
01086,         0,         0,         0,                    0,                      0,                         0
01384,         0,         0,         0,                    0,                      0,                         0
00725,         0,         0,         0,                    0,                      0,                         0
02010,         0,         0,         0,                    0,                      0,                         0
04225,         0,         0,         0,                    0,                      0,                         0
00674,         0,         0,         0,                    0,                      0,                         0
01131,         0,         0,         0,                    0,                      0,                         0
02505,       322,       173,       149,                  312,                      8,                         2
05845,       459,       217,       242,                  389,                     39,                        31
00410,       319,       154,       165,                  285,                     25,                         9
02395,       262,       130,       132,                  248,                      3,                        11
06885,       208,       100,       108,                  194,                     10,                         4
02060,        53,        31,        22,                   52,                      0,                         1
06720,        42,        16,        26,                   36,                      4,                         2
02535,       168,        85,        83,                  111,                      2,                        55
06325,        75,        38,        37,                   67,                      7,                         1
05460,       257,       119,       138,                  208,                     23,                        26
00898,       134,        67,        67,                  129,                      4,                         1
03195,       241,       124,       117,                  227,                      8,                         6
00291,       199,        92,       107,                  192,                      0,                         7
06845,       573,       296,       277,                  541,                     11,                        21
01006,       105,        53,        52,                  103,                      1,                         1
04710,       144,        74,        70,                  125,                      4,                        15
05595,        85,        39,        46,                   79,                      2,                         4
05415,        49,        20,        29,                   46,                      0,                         3
02540,        91,        39,        52,                   57,                     22,                        12
09205,        44,        26,        18,                   38,                      1,                         5
05660,       215,        96,       119,                  213,                      2,                         0
07795,         4,         3,         1,                    4,                      0,                         0
06476,        13,         6,         7,                   13,                      0,                         0
09015,       132,        64,        68,                  126,                      1,                         5
00244,        14,         6,         8,                   14,                      0,                         0
05730,       262,       126,       136,                  255,                      2,                         5
05212,        64,        32,        32,                   63,                      0,                         1
00025,       152,        68,        84,                  122,                     16,                        14
00800,       319,       166,       153,                  265,                     30,                        24
07760,        39,        23,        16,                   37,                      0,                         2
00304,        21,        11,        10,                   21,                      0,                         0
02175,       156,        72,        84,                  153,                      0,                         3
04835,       407,       196,       211,                  370,                      4,                        33
00071,       184,       100,        84,                  168,                     10,                         6
00147,       104,        48,        56,                   94,                      1,                         9
01275,       298,       142,       156,                  260,                     10,                        28
01148,        44,        23,        21,                   44,                      0,                         0
00390,         2,         2,         0,                    2,                      0,                         0
07495,       218,       113,       105,                  200,                      6,                        12
01880,       390,       202,       188,                  340,                     33,                        17
00755,        23,        11,        12,                   23,                      0,                         0
06385,        98,        55,        43,                   71,                     11,                        16
08060,         2,         1,         1,                    2,                      0,                         0
01045,        87,        51,        36,                   86,                      0,                         1
04795,       176,        85,        91,                  129,                     13,                        34
03220,        73,        40,        33,                   67,                      2,                         4
03415,        26,        12,        14,                   23,                      3,                         0
08980,       409,       193,       216,                  387,                      4,                        18
04880,        56,        28,        28,                   52,                      3,                         1
03750,       187,        97,        90,                  178,                      8,                         1
02245,       290,       151,       139,                  283,                      1,                         6
00375,       230,       114,       116,                  224,                      4,                         2
00405,        52,        21,        31,                   49,                      0,                         3
00251,        42,        21,        21,                   41,                      0,                         1
02545,        56,        29,        27,                   53,                      0,                         3
08085,        75,        35,        40,                   71,                      3,                         1
05550,       199,       100,        99,                  182,                     11,                         6
08960,       107,        58,        49,                  102,                      1,                         4
08750,       228,       115,       113,                  198,                      4,                        26
00412,        35,        20,        15,                   32,                      0,                         3
01502,        10,         4,         6,                   10,                      0,                         0
01141,        43,        15,        28,                   43,                      0,                         0
07810,        60,        31,        29,                   58,                      0,                         2
00396,        51,        22,        29,                   48,                      0,                         3
05850,        24,        15,         9,                   24,                      0,                         0
01232,         8,         4,         4,                    8,                      0,                         0
00172,        23,        13,        10,                   23,                      0,                         0
06760,        41,        22,        19,                   39,                      0,                         2
03160,        86,        41,        45,                   73,                      4,                         9
01211,        53,        25,        28,                   46,                      6,                         1
07675,       199,       113,        86,                  186,                      1,                        12
01101,        11,         6,         5,                   11,                      0,                         0
03020,        29,        10,        19,                   26,                      1,                         2
00263,        16,        10,         6,                   12,                      2,                         2
08270,        49,        18,        31,                   47,                      1,                         1
01239,       124,        62,        62,                   85,                     32,                         7
03960,       411,       183,       228,                  343,                     17,                        51
08800,        13,         6,         7,                   13,                      0,                         0
07260,        17,         6,        11,                   17,                      0,                         0
03715,       113,        68,        45,                   89,                      1,                        23
03770,       142,        68,        74,                  124,                      1,                        17
00708,        49,        27,        22,                   48,                      1,                         0
01500,        19,        11,         8,                   12,                      7,                         0
07930,        59,        30,        29,                   58,                      1,                         0
00413,        45,        25,        20,                   44,                      1,                         0
00917,        53,        28,        25,                   53,                      0,                         0
08035,         8,         5,         3,                    8,                      0,                         0
00815,        73,        38,        35,                   73,                      0,                         0
00308,         4,         1,         3,                    4,                      0,                         0
00337,        15,         4,        11,                    6,                      8,                         1
08630,         4,         2,         2,                    4,                      0,                         0
00224,       240,       118,       122,                  218,                      2,                        20
02045,        46,        22,        24,                   46,                      0,                         0
01176,        68,        31,        37,                   65,                      3,                         0
00086,        39,        20,        19,                   37,                      1,                         1
00310,       158,        74,        84,                  152,                      1,                         5
00288,         3,         1,         2,                    3,                      0,                         0
01029,        14,         6,         8,                    9,                      4,                         1
07400,        15,        10,         5,                   15,                      0,                         0
02315,        57,        30,        27,                   48,                      5,                         4
03965,       118,        55,        63,                  116,                      1,                         1
04970,       106,        51,        55,                  105,                      0,                         1
03435,         5,         1,         4,                    5,                      0,                         0
01095,        49,        22,        27,                   48,                      1,                         0
00312,         7,         3,         4,                    6,                      0,                         1
05330,        23,        16,         7,                   23,                      0,                         0
02775,         1,         1,         0,                    1,                      0,                         0
07785,       105,        52,        53,                   55,                      2,                        48
00287,        12,         6,         6,                   10,                      0,                         2
00009,        61,        33,        28,                   61,                      0,                         0
00097,        35,        17,        18,                   30,                      2,                         3
09603,        29,        14,        15,                   29,                      0,                         0
08320,       121,        55,        66,                   79,                      5,                        37
07200,        14,         8,         6,                   14,                      0,                         0
06330,       125,        60,        65,                  124,                      0,                         1
04455,        88,        47,        41,                   88,                      0,                         0
09195,       165,        86,        79,                  108,                      3,                        54
01093,        28,         9,        19,                   25,                      3,                         0
01625,       189,        83,       106,                  173,                      0,                        16
01850,        35,        15,        20,                   35,                      0,                         0
03520,        33,        17,        16,                   33,                      0,                         0
03815,        20,         8,        12,                   19,                      0,                         1
01305,       270,       144,       126,                  261,                      6,                         3
00925,        32,        17,        15,                   32,                      0,                         0
04135,        39,        17,        22,                   39,                      0,                         0
09120,        64,        37,        27,                   56,                      2,                         6
00512,        47,        18,        29,                   47,                      0,                         0
01184,        18,         8,        10,                   16,                      0,                         2
08160,        45,        23,        22,                   22,                     22,                         1
01235,        23,        12,        11,                   23,                      0,                         0
08445,        26,        12,        14,                   24,                      2,                         0
02575,        12,         9,         3,                   11,                      1,                         0
05545,        80,        41,        39,                   73,                      7,                         0
00540,        76,        35,        41,                   74,                      2,                         0
07015,       152,        83,        69,                  142,                      2,                         8
04890,        53,        26,        27,                   53,                      0,                         0
04575,        54,        29,        25,                   46,                      4,                         4
00938,         4,         1,         3,                    4,                      0,                         0
00339,        12,         5,         7,                    8,                      1,                         3
05700,        91,        44,        47,                   90,                      0,                         1
07665,        92,        49,        43,                   90,                      0,                         2
00586,        10,         2,         8,                   10,                      0,                         0
00005,        39,        22,        17,                   38,                      1,                         0
05530,        21,         8,        13,                   21,                      0,                         0
04725,       154,        74,        80,                  110,                      6,                        38
02605,        30,        16,        14,                   30,                      0,                         0
08285,        69,        36,        33,                   65,                      4,                         0
06590,        85,        40,        45,                   74,                      5,                         6
02760,         4,         1,         3,                    4,                      0,                         0
00711,         3,         2,         1,                    3,                      0,                         0
00120,        74,        33,        41,                   55,                      1,                        18
00489,         3,         2,         1,                    3,                      0,                         0
06240,        66,        21,        45,                   62,                      0,                         4
06290,         4,         3,         1,                    4,                      0,                         0
00783,        13,         7,         6,                   13,                      0,                         0
07020,       137,        67,        70,                  132,                      2,                         3
01140,         9,         4,         5,                    8,                      0,                         1
00731,         6,         4,         2,                    6,                      0,                         0
00039,        48,        17,        31,                   44,                      0,                         4
04115,       113,        60,        53,                  105,                      2,                         6
00219,         2,         1,         1,                    2,                      0,                         0
08300,         7,         3,         4,                    7,                      0,                         0
00013,         9,         5,         4,                    9,                      0,                         0
00736,        38,        22,        16,                   38,                      0,                         0
02110,       159,        75,        84,                  143,                      2,                        14
06125,         1,         0,         1,                    1,                      0,                         0
07900,         3,         2,         1,                    3,                      0,                         0
00401,         6,         3,         3,                    6,                      0,                         0
00325,         8,         4,         4,                    8,                      0,                         0
06445,         3,         1,         2,                    3,                      0,                         0
00543,        34,        19,        15,                   28,                      3,                         3
00014,         7,         3,         4,                    7,                      0,                         0
00510,        34,        15,        19,                   29,                      0,                         5
00124,         3,         2,         1,                    3,                      0,                         0
06255,       156,        82,        74,                  150,                      0,                         6
01570,        58,        27,        31,                   58,                      0,                         0
05750,        30,        17,        13,                   30,                      0,                         0
00429,        19,         8,        11,                   19,                      0,                         0
09800,         1,         1,         0,                    1,                      0,                         0
07685,        68,        38,        30,                   68,                      0,                         0
01199,        27,        17,        10,                   26,                      0,                         1
01314,         6,         4,         2,                    3,                      0,                         3
05310,         9,         4,         5,                    6,                      1,                         2
08660,        19,        11,         8,                   16,                      0,                         3
00652,         8,         5,         3,                    8,                      0,                         0
00137,        42,        20,        22,                   38,                      0,                         4
00334,         5,         3,         2,                    5,                      0,                         0
01273,        11,         3,         8,                   10,                      1,                         0
07540,        18,         9,         9,                   18,                      0,                         0
02070,       239,       119,       120,                  226,                      7,                         6
00471,         6,         2,         4,                    6,                      0,                         0
06380,         4,         3,         1,                    4,                      0,                         0
04230,        56,        27,        29,                   56,                      0,                         0
07735,        52,        27,        25,                   47,                      0,                         5
03273,         8,         4,         4,                    8,                      0,                         0
00542,         4,         3,         1,                    4,                      0,                         0
05585,        30,        26,         4,                   29,                      0,                         1
00759,        22,        16,         6,                   22,                      0,                         0
01690,        33,        14,        19,                   31,                      0,                         2
05985,        11,         5,         6,                   11,                      0,                         0
00940,         4,         2,         2,                    3,                      0,                         1
00508,         4,         2,         2,                    4,                      0,                         0
00576,         3,         2,         1,                    3,                      0,                         0
00574,        22,         7,        15,                   21,                      0,                         1
05495,        18,        11,         7,                   17,                      0,                         1
05950,        24,         9,        15,                   24,                      0,                         0
00392,        13,         7,         6,                   13,                      0,                         0
00569,         4,         3,         1,                    4,                      0,                         0
00632,         5,         3,         2,                    5,                      0,                         0
02050,         4,         1,         3,                    4,                      0,                         0
04820,         9,         4,         5,                    9,                      0,                         0
01197,         1,         0,         1,                    1,                      0,                         0
00089,         5,         2,         3,                    5,                      0,                         0
06625,       114,        58,        56,                  109,                      0,                         5
07705,        13,         7,         6,                   13,                      0,                         0
00356,         4,         2,         2,                    4,                      0,                         0
06460,        15,        11,         4,                   15,                      0,                         0
01460,        46,        20,        26,                   46,                      0,                         0
00777,        12,         7,         5,                   12,                      0,                         0
05970,        50,        21,        29,                   50,                      0,                         0
00812,         8,         4,         4,                    8,                      0,                         0
02015,        52,        30,        22,                   52,                      0,                         0
08920,        10,         6,         4,                   10,                      0,                         0
00204,         4,         3,         1,                    4,                      0,                         0
00789,         1,         0,         1,                    1,                      0,                         0
00858,         7,         3,         4,                    7,                      0,                         0
00183,        10,         4,         6,                    8,                      1,                         1
01865,        22,        12,        10,                   22,                      0,                         0
08765,        25,        14,        11,                   25,                      0,                         0
07860,        28,        16,        12,                   26,                      2,                         0
01595,        14,         8,         6,                   14,                      0,                         0
00186,         5,         2,         3,                    5,                      0,                         0
00490,       149,        64,        85,                  143,                      5,                         1
07865,        12,         5,         7,                   12,                      0,                         0
01204,         5,         2,         3,                    5,                      0,                         0
01915,        16,        10,         6,                   16,                      0,                         0
03005,         4,         2,         2,                    4,                      0,                         0
00178,        16,         8,         8,                   16,                      0,                         0
08555,         8,         4,         4,                    8,                      0,                         0
08575,         8,         5,         3,                    8,                      0,                         0
03240,         2,         1,         1,                    2,                      0,                         0
00691,         4,         2,         2,                    4,                      0,                         0
05172,        17,         7,        10,                   17,                      0,                         0
00443,         3,         1,         2,                    3,                      0,                         0
08245,         3,         1,         2,                    3,                      0,                         0
04460,         3,         2,         1,                    3,                      0,                         0
00769,         1,         1,         0,                    1,                      0,                         0
02185,         3,         2,         1,                    3,                      0,                         0
01158,        15,         6,         9,                   14,                      0,                         1
01192,         2,         2,         0,                    2,                      0,                         0
05790,         0,         0,         0,                    0,                      0,                         0
01138,         0,         0,         0,                    0,                      0,                         0
00407,         0,         0,         0,                    0,                      0,                         0
00522,         0,         0,         0,                    0,                      0,                         0
00354,         0,         0,         0,                    0,                      0,                         0
00239,         0,         0,         0,                    0,                      0,                         0
00780,         0,         0,         0,                    0,                      0,                         0
00341,         0,         0,         0,                    0,                      0,                         0
00695,         0,         0,         0,                    0,                      0,                         0
01242,         0,         0,         0,                    0,                      0,                         0
00971,         0,         0,         0,                    0,                      0,                         0
00322,         0,         0,         0,                    0,                      0,                         0
00848,         0,         0,         0,                    0,                      0,                         0
00476,         0,         0,         0,                    0,                      0,                         0
01149,         0,         0,         0,                    0,                      0,                         0
04942,         0,         0,         0,                    0,                      0,                         0
03560,         0,         0,         0,                    0,                      0,                         0
00102,         0,         0,         0,                    0,                      0,                         0
00313,         0,         0,         0,                    0,                      0,                         0
03150,       132,        52,        80,                  132,                      0,                         0
04450,        59,        31,        28,                   54,                      0,                         5
01540,       340,       150,       190,                  307,                     21,                        12
07100,       153,        76,        77,                  135,                      2,                        16
06260,        29,        15,        14,                   28,                      0,                         1
00234,        16,         6,        10,                   16,                      0,                         0
00962,       200,       113,        87,                  193,                      5,                         2
05915,        48,        23,        25,                   48,                      0,                         0
09967,       339,       157,       182,                  331,                      2,                         6
09963,       238,       115,       123,                  213,                      9,                        16
00376,        19,        13,         6,                   19,                      0,                         0
01280,       350,       165,       185,                  333,                      2,                        15
00920,        83,        52,        31,                   82,                      1,                         0
09055,       196,        99,        97,                  158,                      1,                        37
01244,        26,         8,        18,                   18,                      6,                         2
00109,        26,        13,        13,                   24,                      0,                         2
08825,       906,       439,       467,                  875,                      7,                        24
04665,       112,        54,        58,                  110,                      0,                         2
02032,        74,        34,        40,                   71,                      2,                         1
02845,        17,         9,         8,                   15,                      1,                         1
09961,       250,       125,       125,                  237,                      5,                         8
00926,        20,         8,        12,                   20,                      0,                         0
00010,       397,       192,       205,                  366,                      5,                        26
00534,        25,        14,        11,                   25,                      0,                         0
00775,        29,        15,        14,                   29,                      0,                         0
04910,       337,       177,       160,                  326,                      3,                         8
03060,        88,        43,        45,                   84,                      1,                         3
06090,        40,        20,        20,                   39,                      1,                         0
01005,        34,        14,        20,                   34,                      0,                         0
07280,       138,        67,        71,                  120,                     12,                         6
02120,       239,       108,       131,                  212,                      7,                        20
08335,        41,        26,        15,                   40,                      1,                         0
05980,       154,        73,        81,                  138,                      6,                        10
03585,       379,       185,       194,                  340,                     25,                        14
06430,       291,       138,       153,                  252,                     28,                        11
06960,       234,       108,       126,                  223,                      8,                         3
02215,        56,        30,        26,                   47,                      3,                         6
02610,       475,       240,       235,                  333,                     77,                        65
06970,       729,       370,       359,                  695,                     11,                        23
01004,        44,        20,        24,                   44,                      0,                         0
06375,       705,       330,       375,                  576,                     24,                       105
01165,        96,        44,        52,                   76,                     10,                        10
00332,       102,        49,        53,                  100,                      0,                         2
08815,        54,        25,        29,                   53,                      0,                         1
08170,       113,        67,        46,                  106,                      3,                         4
00238,         9,         4,         5,                    7,                      1,                         1
02700,        13,         8,         5,                   13,                      0,                         0
01272,        83,        37,        46,                   79,                      2,                         2
05710,       227,       100,       127,                  172,                     20,                        35
00374,        22,        10,        12,                   21,                      0,                         1
01765,       105,        49,        56,                  102,                      1,                         2
08365,        72,        34,        38,                   68,                      2,                         2
00180,        46,        23,        23,                   43,                      3,                         0
04495,        97,        49,        48,                   88,                      1,                         8
00029,        25,        12,        13,                   25,                      0,                         0
01249,        16,         7,         9,                   16,                      0,                         0
04410,        51,        21,        30,                   49,                      2,                         0
04210,        27,        13,        14,                   24,                      2,                         1
02300,       431,       220,       211,                  377,                     17,                        37
01210,        12,         5,         7,                   12,                      0,                         0
07590,        99,        42,        57,                   86,                      2,                        11
09969,       838,       384,       454,                  813,                      8,                        17
01475,        75,        45,        30,                   70,                      1,                         4
07585,        86,        42,        44,                   81,                      2,                         3
01620,        43,        18,        25,                   34,                      3,                         6
03070,       486,       234,       252,                  447,                      3,                        36
00923,        18,         7,        11,                   17,                      0,                         1
02995,        79,        35,        44,                   79,                      0,                         0
05590,       149,        75,        74,                  136,                     13,                         0
05720,        52,        27,        25,                   28,                     22,                         2
00269,         9,         5,         4,                    9,                      0,                         0
02810,       335,       161,       174,                  306,                     18,                        11
00254,        22,        12,        10,                   22,                      0,                         0
01520,       223,        94,       129,                  190,                     24,                         9
07890,        28,        14,        14,                   28,                      0,                         0
04700,        40,        18,        22,                   40,                      0,                         0
08410,        39,        17,        22,                   36,                      0,                         3
00298,         3,         2,         1,                    3,                      0,                         0
05945,        37,        17,        20,                   35,                      2,                         0
05165,        99,        45,        54,                   94,                      4,                         1
00404,        35,        19,        16,                   11,                     20,                         4
03845,       447,       223,       224,                  440,                      2,                         5
00256,        17,         8,         9,                   17,                      0,                         0
06750,       124,        58,        66,                  106,                      4,                        14
00123,        47,        25,        22,                   47,                      0,                         0
01785,        86,        41,        45,                   84,                      2,                         0
09973,        52,        26,        26,                   50,                      0,                         2
08885,         8,         4,         4,                    7,                      0,                         1
08860,        49,        26,        23,                   49,                      0,                         0
00568,       258,       134,       124,                  255,                      2,                         1
01835,       233,       109,       124,                  173,                      3,                        57
01258,        35,        13,        22,                   34,                      0,                         1
02055,        34,        20,        14,                   32,                      2,                         0
05940,        54,        29,        25,                   53,                      1,                         0
05115,        44,        22,        22,                   41,                      3,                         0
03115,        99,        55,        44,                   99,                      0,                         0
02380,        66,        29,        37,                   66,                      0,                         0
01030,         2,         2,         0,                    2,                      0,                         0
06467,        93,        39,        54,                   90,                      3,                         0
04120,        86,        41,        45,                   85,                      0,                         1
05261,        19,         9,        10,                   19,                      0,                         0
00309,         8,         5,         3,                    8,                      0,                         0
00545,       133,        55,        78,                  126,                      2,                         5
02005,        13,         6,         7,                   13,                      0,                         0
06890,         6,         4,         2,                    4,                      0,                         2
00928,        24,        12,        12,                   24,                      0,                         0
04705,        26,        13,        13,                   21,                      0,                         5
04340,        16,        11,         5,                   16,                      0,                         0
00439,        36,        20,        16,                   35,                      0,                         1
00197,         3,         1,         2,                    3,                      0,                         0
08175,        88,        46,        42,                   86,                      1,                         1
06950,       118,        57,        61,                  116,                      0,                         2
08865,        88,        44,        44,                   87,                      1,                         0
04805,       239,       111,       128,                  209,                      4,                        26
02650,         8,         5,         3,                    8,                      0,                         0
06671,        83,        37,        46,                   79,                      0,                         4
01900,        60,        32,        28,                   60,                      0,                         0
01590,        20,         8,        12,                   19,                      0,                         1
02105,        33,        16,        17,                   33,                      0,                         0
08460,        14,         7,         7,                   14,                      0,                         0
01297,         3,         2,         1,                    3,                      0,                         0
01395,        71,        36,        35,                   68,                      0,                         3
00406,        30,        13,        17,                   30,                      0,                         0
09235,        11,         5,         6,                   11,                      0,                         0
00983,        15,         9,         6,                   15,                      0,                         0
06990,       203,        89,       114,                  197,                      1,                         5
07650,        20,        10,        10,                   20,                      0,                         0
06900,        90,        38,        52,                   81,                      0,                         9
07630,       137,        68,        69,                  133,                      1,                         3
09035,       126,        63,        63,                   98,                      7,                        21
00922,        33,        19,        14,                   31,                      0,                         2
01283,        16,        10,         6,                   15,                      0,                         1
00078,        21,        12,         9,                   14,                      1,                         6
00114,        14,         9,         5,                   13,                      1,                         0
00735,        81,        50,        31,                   75,                      6,                         0
03000,         4,         1,         3,                    2,                      1,                         1
00714,        22,         9,        13,                   16,                      2,                         4
01257,        41,        22,        19,                   39,                      1,                         1
00758,        36,        19,        17,                   35,                      0,                         1
08395,       199,        99,       100,                  187,                      6,                         6
08080,         4,         1,         3,                    4,                      0,                         0
07415,        84,        41,        43,                   76,                      0,                         8
01510,        94,        43,        51,                   92,                      1,                         1
07545,       459,       210,       249,                  396,                      1,                        62
01995,         7,         3,         4,                    7,                      0,                         0
00570,         6,         4,         2,                    6,                      0,                         0
04570,         3,         2,         1,                    3,                      0,                         0
01391,         5,         2,         3,                    5,                      0,                         0
08150,        93,        44,        49,                   91,                      1,                         1
00442,        62,        33,        29,                   54,                      2,                         6
00881,        30,        13,        17,                   30,                      0,                         0
01125,         2,         1,         1,                    2,                      0,                         0
02725,        84,        44,        40,                   77,                      6,                         1
01020,        89,        44,        45,                   79,                      0,                        10
00152,        60,        29,        31,                   50,                      0,                        10
04130,        28,        12,        16,                   28,                      0,                         0
08730,        24,        13,        11,                   24,                      0,                         0
03995,        50,        19,        31,                   40,                      3,                         7
04095,       147,        74,        73,                  138,                      4,                         5
01262,        48,        17,        31,                   48,                      0,                         0
06475,        35,        16,        19,                   35,                      0,                         0
00171,        42,        25,        17,                   42,                      0,                         0
06000,        16,         8,         8,                   16,                      0,                         0
03820,        28,        20,         8,                   27,                      0,                         1
01015,        24,        12,        12,                   24,                      0,                         0
00730,        27,        15,        12,                   27,                      0,                         0
08065,        72,        39,        33,                   53,                      3,                        16
00732,        16,         8,         8,                   16,                      0,                         0
00015,        14,         7,         7,                   14,                      0,                         0
06581,        10,         4,         6,                   10,                      0,                         0
02905,        99,        44,        55,                   92,                      1,                         6
02385,        47,        29,        18,                   45,                      0,                         2
00022,        15,         6,         9,                   15,                      0,                         0
00027,         6,         3,         3,                    6,                      0,                         0
00663,        11,         7,         4,                   11,                      0,                         0
00382,         9,         4,         5,                    9,                      0,                         0
08770,        22,         8,        14,                   15,                      2,                         5
00738,         8,         4,         4,                    8,                      0,                         0
01349,         4,         3,         1,                    4,                      0,                         0
01002,        14,         8,         6,                   13,                      0,                         1
06875,         3,         1,         2,                    3,                      0,                         0
01118,         2,         2,         0,                    2,                      0,                         0
08385,        15,         7,         8,                   15,                      0,                         0
00743,         9,         5,         4,                    9,                      0,                         0
00751,        20,        13,         7,                   20,                      0,                         0
00402,        26,        15,        11,                   26,                      0,                         0
02130,        17,        10,         7,                   15,                      0,                         2
00169,        22,        12,        10,                   21,                      0,                         1
01237,         8,         4,         4,                    8,                      0,                         0
08345,         6,         2,         4,                    5,                      0,                         1
00426,        13,         6,         7,                   13,                      0,                         0
00052,        16,         8,         8,                   16,                      0,                         0
09045,        49,        27,        22,                   42,                      0,                         7
07455,        19,         7,        12,                   18,                      1,                         0
00370,        40,        17,        23,                   39,                      1,                         0
08230,       101,        48,        53,                   90,                      0,                        11
01251,        27,        13,        14,                   26,                      1,                         0
00449,        10,         7,         3,                    9,                      0,                         1
00467,        23,        10,        13,                   23,                      0,                         0
00466,        14,         5,         9,                   14,                      0,                         0
00095,        37,        20,        17,                   26,                     11,                         0
00150,        84,        41,        43,                   79,                      1,                         4
01323,         5,         4,         1,                    5,                      0,                         0
09030,        95,        56,        39,                   68,                      1,                        26
07815,        45,        16,        29,                   42,                      0,                         3
06940,        16,         8,         8,                   14,                      0,                         2
04930,        23,        12,        11,                   14,                      0,                         9
07520,        12,         6,         6,                   12,                      0,                         0
06390,        44,        21,        23,                   39,                      4,                         1
01780,        45,        21,        24,                   45,                      0,                         0
00524,        12,         4,         8,                   12,                      0,                         0
00726,         6,         4,         2,                    6,                      0,                         0
00492,         9,         4,         5,                    9,                      0,                         0
07050,         3,         1,         2,                    3,                      0,                         0
08875,        10,         6,         4,                    9,                      1,                         0
00509,         3,         1,         2,                    3,                      0,                         0
08845,         3,         2,         1,                    3,                      0,                         0
01189,         7,         3,         4,                    7,                      0,                         0
00493,         2,         1,         1,                    2,                      0,                         0
01198,         3,         2,         1,                    3,                      0,                         0
00511,         4,         1,         3,                    4,                      0,                         0
00583,         5,         3,         2,                    5,                      0,                         0
00591,         1,         1,         0,                    1,                      0,                         0
00588,         4,         3,         1,                    4,                      0,                         0
00904,         3,         2,         1,                    3,                      0,                         0
00931,         4,         2,         2,                    4,                      0,                         0
01380,        17,        10,         7,                   17,                      0,                         0
00603,         6,         2,         4,                    5,                      1,                         0
02145,        17,         7,        10,                   17,                      0,                         0
05820,        33,        17,        16,                   33,                      0,                         0
00593,        13,         5,         8,                   13,                      0,                         0
00541,         1,         1,         0,                    1,                      0,                         0
04895,         8,         5,         3,                    8,                      0,                         0
02815,         5,         2,         3,                    4,                      0,                         1
04695,        15,         6,         9,                   15,                      0,                         0
00621,         8,         3,         5,                    8,                      0,                         0
00132,        10,         4,         6,                   10,                      0,                         0
00842,         7,         3,         4,                    7,                      0,                         0
01910,        32,        15,        17,                   31,                      1,                         0
00182,         8,         4,         4,                    8,                      0,                         0
00796,        17,         8,         9,                   17,                      0,                         0
00754,         5,         2,         3,                    5,                      0,                         0
00628,         7,         4,         3,                    7,                      0,                         0
00833,         7,         2,         5,                    7,                      0,                         0
01920,        49,        23,        26,                   48,                      0,                         1
00596,         5,         2,         3,                    5,                      0,                         0
05085,        38,        20,        18,                   37,                      0,                         1
00395,         7,         4,         3,                    6,                      1,                         0
00834,         8,         2,         6,                    7,                      0,                         1
02465,        23,        14,         9,                   23,                      0,                         0
01084,         3,         1,         2,                    3,                      0,                         0
05220,        21,        10,        11,                   20,                      1,                         0
00649,        14,         8,         6,                   12,                      0,                         2
08540,        33,        22,        11,                   22,                     11,                         0
00167,        27,        18,         9,                   27,                      0,                         0
08105,         4,         2,         2,                    4,                      0,                         0
00641,        15,         6,         9,                   12,                      2,                         1
06030,         3,         1,         2,                    3,                      0,                         0
03625,        30,        17,        13,                   30,                      0,                         0
01150,         6,         3,         3,                    6,                      0,                         0
06755,        67,        31,        36,                   65,                      0,                         2
08155,         9,         6,         3,                    9,                      0,                         0
01209,         2,         1,         1,                    2,                      0,                         0
00349,        24,        13,        11,                   24,                      0,                         0
05525,        30,        11,        19,                   30,                      0,                         0
01000,         3,         2,         1,                    2,                      1,                         0
00793,         6,         2,         4,                    6,                      0,                         0
00808,         4,         3,         1,                    4,                      0,                         0
04600,        24,        11,        13,                   24,                      0,                         0
00810,        15,         7,         8,                   15,                      0,                         0
06800,        31,        19,        12,                   30,                      0,                         1
00945,        10,         5,         5,                   10,                      0,                         0
05935,        12,         5,         7,                   12,                      0,                         0
00336,         6,         3,         3,                    6,                      0,                         0
00668,         4,         2,         2,                    4,                      0,                         0
01289,         3,         3,         0,                    3,                      0,                         0
04350,        15,         7,         8,                   15,                      0,                         0
03660,         3,         1,         2,                    3,                      0,                         0
01064,         1,         1,         0,                    1,                      0,                         0
08910,         8,         7,         1,                    0,                      8,                         0
09236,        18,         9,         9,                   18,                      0,                         0
00946,         2,         1,         1,                    2,                      0,                         0
01735,         1,         1,         0,                    1,                      0,                         0
00853,         3,         2,         1,                    3,                      0,                         0
00678,         2,         2,         0,                    2,                      0,                         0
01368,         0,         0,         0,                    0,                      0,                         0
00592,         0,         0,         0,                    0,                      0,                         0
00733,         0,         0,         0,                    0,                      0,                         0
01345,         0,         0,         0,                    0,                      0,                         0
00264,         0,         0,         0,                    0,                      0,                         0
05410,         0,         0,         0,                    0,                      0,                         0
00844,         0,         0,         0,                    0,                      0,                         0
07085,         0,         0,         0,                    0,                      0,                         0
00230,         0,         0,         0,                    0,                      0,                         0
06520,         0,         0,         0,                    0,                      0,                         0
00060,         0,         0,         0,                    0,                      0,                         0
06145,         0,         0,         0,                    0,                      0,                         0
03355,       217,       104,       113,                  184,                     18,                        15
00002,       214,       107,       107,                  194,                     14,                         6
08820,       602,       295,       307,                  580,                      8,                        14
04405,       134,        56,        78,                   98,                     17,                        19
07570,       181,        75,       106,                  167,                      0,                        14
06665,        31,        15,        16,                   27,                      4,                         0
07390,       585,       295,       290,                  558,                      7,                        20
03510,       246,       116,       130,                  233,                      5,                         8
01159,        21,         9,        12,                   21,                      0,                         0
05810,       113,        63,        50,                  106,                      1,                         6
00785,       293,       158,       135,                  224,                     57,                        12
07800,       110,        58,        52,                   79,                     20,                        11
04085,        10,         6,         4,                   10,                      0,                         0
01505,      3557,      1766,      1791,                 3198,                     31,                       328
07645,        42,        20,        22,                   42,                      0,                         0
07710,        18,         8,        10,                   18,                      0,                         0
01094,       192,       104,        88,                  169,                      7,                        16
04860,       362,       183,       179,                  292,                     47,                        23
08135,       143,        70,        73,                  140,                      1,                         2
02590,        31,        17,        14,                   31,                      0,                         0
09966,        76,        37,        39,                   76,                      0,                         0
03420,       844,       366,       478,                  693,                     99,                        52
00435,       460,       231,       229,                  424,                     10,                        26
06070,        53,        29,        24,                   52,                      0,                         1
05655,        56,        31,        25,                   55,                      0,                         1
07505,       145,        73,        72,                  133,                      4,                         8
04745,       156,        75,        81,                  143,                      5,                         8
02435,        98,        50,        48,                   97,                      1,                         0
01320,         1,         1,         0,                    1,                      0,                         0
06865,       108,        57,        51,                  107,                      0,                         1
03970,         8,         7,         1,                    6,                      0,                         2
09590,        14,         8,         6,                   14,                      0,                         0
04145,       239,       123,       116,                  213,                      3,                        23
01274,        88,        40,        48,                   82,                      0,                         6
08930,       154,        73,        81,                  136,                      2,                        16
00700,        36,        18,        18,                   35,                      0,                         1
08720,       274,       127,       147,                  255,                     11,                         8
01088,        89,        42,        47,                   85,                      2,                         2
04945,       179,        87,        92,                  175,                      0,                         4
00970,       506,       248,       258,                  474,                      5,                        27
00895,       193,       100,        93,                  185,                      3,                         5
00021,       128,        68,        60,                  125,                      0,                         3
08280,       110,        50,        60,                   93,                      8,                         9
01965,       112,        62,        50,                   61,                     20,                        31
00952,         7,         2,         5,                    6,                      0,                         1
08030,       119,        60,        59,                  100,                     14,                         5
00826,         7,         4,         3,                    7,                      0,                         0
00101,         4,         2,         2,                    4,                      0,                         0
01155,       231,       106,       125,                  220,                      4,                         7
07145,        20,        11,         9,                   20,                      0,                         0
02877,       172,        90,        82,                  131,                     13,                        28
01640,       341,       161,       180,                  243,                     58,                        40
00295,        55,        24,        31,                   51,                      2,                         2
07490,       172,        84,        88,                  167,                      0,                         5
04790,        34,        14,        20,                   33,                      1,                         0
02140,       193,        97,        96,                  180,                     10,                         3
05285,        18,         8,        10,                   13,                      3,                         2
01183,        30,        17,        13,                   29,                      0,                         1
08700,        82,        50,        32,                   75,                      2,                         5
03525,        29,        12,        17,                   29,                      0,                         0
00740,       107,        55,        52,                   90,                      4,                        13
05475,        21,         9,        12,                   20,                      0,                         1
07220,        74,        38,        36,                   74,                      0,                         0
00960,        97,        51,        46,                   93,                      0,                         4
05185,        25,        13,        12,                   24,                      1,                         0
03340,       305,       152,       153,                  289,                      4,                        12
00133,       111,        48,        63,                  109,                      2,                         0
01680,        37,        20,        17,                   37,                      0,                         0
05295,        85,        42,        43,                   83,                      1,                         1
04515,        69,        36,        33,                   64,                      3,                         2
00240,        85,        42,        43,                   78,                      2,                         5
00368,        48,        25,        23,                   47,                      0,                         1
04025,       148,        76,        72,                  137,                      7,                         4
06230,        18,         9,         9,                   16,                      0,                         2
00268,         9,         6,         3,                    9,                      0,                         0
00969,        12,         7,         5,                   12,                      0,                         0
08450,        54,        30,        24,                   42,                      0,                        12
00258,        19,        10,         9,                   17,                      0,                         2
04520,        65,        38,        27,                   47,                      6,                        12
04510,        48,        21,        27,                   47,                      0,                         1
00261,         2,         1,         1,                    2,                      0,                         0
05130,        24,        16,         8,                   22,                      2,                         0
02795,        21,        11,        10,                   21,                      0,                         0
08940,        80,        38,        42,                   78,                      0,                         2
00941,        11,         7,         4,                   11,                      0,                         0
00257,         7,         2,         5,                    7,                      0,                         0
07160,        97,        42,        55,                   89,                      2,                         6
01255,        24,        11,        13,                   24,                      0,                         0
07195,       138,        62,        76,                  132,                      6,                         0
03635,        74,        40,        34,                   65,                      8,                         1
03785,        89,        42,        47,                   82,                      0,                         7
04335,        26,        12,        14,                   26,                      0,                         0
06480,        18,         7,        11,                   16,                      0,                         2
00036,        68,        39,        29,                   68,                      0,                         0
01240,        25,         8,        17,                   25,                      0,                         0
00303,        16,         7,         9,                   16,                      0,                         0
05565,         6,         4,         2,                    6,                      0,                         0
00571,         5,         3,         2,                    5,                      0,                         0
09601,       121,        62,        59,                  117,                      2,                         2
08705,        65,        30,        35,                   65,                      0,                         0
00282,        50,        25,        25,                   49,                      1,                         0
00307,         4,         3,         1,                    4,                      0,                         0
05865,        52,        29,        23,                   52,                      0,                         0
05500,        38,        21,        17,                   36,                      0,                         2
02945,        19,        10,         9,                   18,                      0,                         1
05315,        34,        18,        16,                   34,                      0,                         0
05465,        48,        26,        22,                   44,                      3,                         1
04490,        69,        34,        35,                   69,                      0,                         0
04870,        77,        37,        40,                   64,                      9,                         4
00112,        21,         9,        12,                   21,                      0,                         0
07290,       567,       286,       281,                  510,                     11,                        46
00558,        22,         8,        14,                   22,                      0,                         0
08165,       117,        57,        60,                  107,                      5,                         5
00154,         6,         3,         3,                    6,                      0,                         0
00590,        17,         9,         8,                   17,                      0,                         0
07355,        81,        39,        42,                   71,                      0,                        10
01545,        74,        34,        40,                   67,                      3,                         4
01115,        41,        21,        20,                   41,                      0,                         0
05180,       154,        80,        74,                  151,                      0,                         3
00069,       112,        51,        61,                  106,                      4,                         2
03175,       251,       120,       131,                  221,                      2,                        28
05425,       100,        41,        59,                   70,                     27,                         3
00082,        14,         6,         8,                   11,                      1,                         2
07480,       209,       107,       102,                  202,                      3,                         4
00369,         3,         1,         2,                    3,                      0,                         0
01147,        57,        28,        29,                   54,                      1,                         2
01337,         2,         1,         1,                    2,                      0,                         0
05060,       165,        83,        82,                  133,                      4,                        28
00061,         4,         1,         3,                    4,                      0,                         0
00707,        13,         4,         9,                   13,                      0,                         0
00921,        87,        39,        48,                   87,                      0,                         0
00954,        26,        11,        15,                   17,                      9,                         0
08305,        91,        49,        42,                   86,                      2,                         3
06345,        16,         9,         7,                   16,                      0,                         0
05745,        25,        12,        13,                   24,                      0,                         1
03640,         6,         3,         3,                    6,                      0,                         0
01180,        34,        18,        16,                   21,                     13,                         0
00158,       107,        56,        51,                  105,                      0,                         2
06275,        11,         4,         7,                   11,                      0,                         0
01228,         8,         7,         1,                    8,                      0,                         0
00999,        28,        15,        13,                   28,                      0,                         0
04165,        72,        32,        40,                   69,                      0,                         3
00464,        16,         7,         9,                   16,                      0,                         0
00157,       274,       137,       137,                  265,                      0,                         9
00065,        95,        52,        43,                   89,                      2,                         4
05070,        32,        16,        16,                   29,                      1,                         2
05765,        81,        35,        46,                   81,                      0,                         0
00365,       237,       117,       120,                  203,                      4,                        30
00372,        16,         9,         7,                   16,                      0,                         0
05225,        73,        40,        33,                   68,                      1,                         4
02730,        79,        34,        45,                   64,                      0,                        15
03685,       102,        52,        50,                   97,                      4,                         1
02510,        10,         4,         6,                    6,                      3,                         1
05630,        50,        27,        23,                   37,                     11,                         2
06935,       141,        68,        73,                  100,                      6,                        35
04435,        34,        18,        16,                   32,                      1,                         1
07055,        70,        35,        35,                   62,                      0,                         8
03165,        23,        11,        12,                   23,                      0,                         0
05835,        25,        15,        10,                   25,                      0,                         0
00118,        11,         7,         4,                   11,                      0,                         0
00378,        17,        10,         7,                   16,                      1,                         0
05215,        40,        20,        20,                   40,                      0,                         0
08530,        72,        37,        35,                   68,                      2,                         2
01154,        11,         6,         5,                    9,                      0,                         2
05205,        50,        25,        25,                   50,                      0,                         0
00011,        11,         6,         5,                   11,                      0,                         0
06155,         4,         3,         1,                    3,                      0,                         1
01202,         6,         2,         4,                    6,                      0,                         0
01321,        28,        10,        18,                   19,                      0,                         9
04960,         2,         1,         1,                    2,                      0,                         0
01315,        98,        45,        53,                   82,                      0,                        16
00605,        46,        27,        19,                   37,                      0,                         9
00047,        14,         7,         7,                   14,                      0,                         0
00028,        14,         7,         7,                   14,                      0,                         0
00737,        12,         4,         8,                   12,                      0,                         0
00728,         8,         4,         4,                    8,                      0,                         0
00386,         1,         0,         1,                    1,                      0,                         0
00217,        15,         8,         7,                   15,                      0,                         0
01340,         1,         1,         0,                    1,                      0,                         0
00072,        29,        10,        19,                   29,                      0,                         0
00301,         7,         2,         5,                    7,                      0,                         0
00051,        13,         6,         7,                   10,                      0,                         3
00393,         8,         4,         4,                    8,                      0,                         0
06810,        20,         6,        14,                   20,                      0,                         0
01342,         7,         3,         4,                    7,                      0,                         0
03265,       102,        50,        52,                  100,                      0,                         2
06730,        50,        26,        24,                   50,                      0,                         0
01253,        18,        10,         8,                   18,                      0,                         0
00724,         4,         2,         2,                    4,                      0,                         0
00221,        20,         7,        13,                   17,                      1,                         2
00456,         5,         2,         3,                    5,                      0,                         0
00062,        43,        24,        19,                   40,                      0,                         3
09105,         7,         2,         5,                    7,                      0,                         0
06965,        38,        18,        20,                   33,                      0,                         5
08100,        82,        36,        46,                   73,                      5,                         4
05715,        19,        10,         9,                   17,                      0,                         2
00501,        12,         6,         6,                   12,                      0,                         0
04105,        10,         4,         6,                   10,                      0,                         0
06735,        45,        23,        22,                   40,                      5,                         0
02625,        33,        14,        19,                   31,                      0,                         2
00111,        55,        26,        29,                   54,                      0,                         1
08200,         5,         3,         2,                    3,                      2,                         0
00290,        12,         7,         5,                   12,                      0,                         0
01299,         2,         1,         1,                    2,                      0,                         0
00523,         6,         3,         3,                    5,                      0,                         1
00196,         5,         3,         2,                    5,                      0,                         0
04440,        57,        24,        33,                   57,                      0,                         0
00087,        16,         8,         8,                   16,                      0,                         0
01252,         4,         2,         2,                    4,                      0,                         0
00155,         5,         3,         2,                    5,                      0,                         0
06410,        21,         9,        12,                   21,                      0,                         0
00518,         1,         1,         0,                    1,                      0,                         0
03505,        20,        14,         6,                   20,                      0,                         0
07910,         4,         2,         2,                    4,                      0,                         0
00798,        10,         6,         4,                   10,                      0,                         0
00779,        16,         6,        10,                   16,                      0,                         0
03385,        12,         5,         7,                   12,                      0,                         0
08970,         7,         2,         5,                    7,                      0,                         0
01225,        22,        12,        10,                   22,                      0,                         0
01310,       110,        51,        59,                  107,                      3,                         0
03495,        23,        14,         9,                   16,                      7,                         0
03620,        10,         5,         5,                   10,                      0,                         0
00190,         4,         3,         1,                    3,                      1,                         0
09010,        36,        18,        18,                   36,                      0,                         0
08550,        14,         8,         6,                   14,                      0,                         0
00338,        16,         9,         7,                   16,                      0,                         0
07850,         1,         0,         1,                    1,                      0,                         0
02765,        13,         8,         5,                   13,                      0,                         0
03030,        11,         5,         6,                   11,                      0,                         0
00654,         8,         5,         3,                    8,                      0,                         0
07870,         5,         2,         3,                    5,                      0,                         0
00342,        12,         5,         7,                   12,                      0,                         0
01480,        54,        27,        27,                   54,                      0,                         0
04040,        11,         7,         4,                   11,                      0,                         0
05755,        57,        29,        28,                   55,                      0,                         2
02950,        22,        13,         9,                   22,                      0,                         0
04800,         6,         3,         3,                    6,                      0,                         0
03705,        31,        19,        12,                   19,                     12,                         0
01229,         3,         1,         2,                    3,                      0,                         0
01795,        49,        24,        25,                   47,                      0,                         2
00974,         2,         1,         1,                    1,                      0,                         1
00855,         3,         1,         2,                    3,                      0,                         0
05280,         2,         2,         0,                    1,                      1,                         0
00451,         4,         4,         0,                    4,                      0,                         0
02125,         2,         1,         1,                    2,                      0,                         0
01146,         3,         1,         2,                    3,                      0,                         0
01386,         2,         2,         0,                    2,                      0,                         0
01157,         3,         2,         1,                    3,                      0,                         0
00937,         4,         3,         1,                    2,                      1,                         1
00587,         1,         1,         0,                    1,                      0,                         0
00423,         3,         2,         1,                    3,                      0,                         0
03745,         2,         1,         1,                    2,                      0,                         0
01288,         2,         1,         1,                    2,                      0,                         0
00500,         0,         0,         0,                    0,                      0,                         0
00345,         0,         0,         0,                    0,                      0,                         0
09977,         0,         0,         0,                    0,                      0,                         0
00433,         0,         0,         0,                    0,                      0,                         0
01425,         0,         0,         0,                    0,                      0,                         0
06180,         0,         0,         0,                    0,                      0,                         0
09155,         0,         0,         0,                    0,                      0,                         0
00237,         0,         0,         0,                    0,                      0,                         0
00718,         0,         0,         0,                    0,                      0,                         0
00822,         0,         0,         0,                    0,                      0,                         0
00597,         0,         0,         0,                    0,                      0,                         0
00886,         0,         0,         0,                    0,                      0,                         0
09965,         0,         0,         0,                    0,                      0,                         0
07780,         0,         0,         0,                    0,                      0,                         0
01222,         0,         0,         0,                    0,                      0,                         0
00795,         0,         0,         0,                    0,                      0,                         0
06685,         0,         0,         0,                    0,                      0,                         0
09593,         0,         0,         0,                    0,                      0,                         0
01745,         0,         0,         0,                    0,                      0,                         0
06955,         0,         0,         0,                    0,                      0,                         0
07945,         0,         0,         0,                    0,                      0,                         0
03945,       254,       129,       125,                  248,                      4,                         2
04645,        92,        51,        41,                   88,                      1,                         3
08780,       432,       214,       218,                  401,                     17,                        14
00008,        29,        13,        16,                   29,                      0,                         0
05090,       193,        87,       106,                  164,                     24,                         5
00164,         7,         3,         4,                    7,                      0,                         0
01440,       773,       357,       416,                  739,                     13,                        21
02985,        71,        39,        32,                   71,                      0,                         0
00950,       108,        51,        57,                  103,                      3,                         2
00115,        33,        17,        16,                   27,                      2,                         4
00220,       477,       234,       243,                  439,                     21,                        17
00146,       966,       473,       493,                  900,                     12,                        54
04675,        50,        27,        23,                   42,                      1,                         7
03040,       249,       125,       124,                  242,                      7,                         0
03955,        50,        25,        25,                   49,                      0,                         1
06510,        79,        16,        63,                   64,                     10,                         5
00348,       281,       142,       139,                  265,                      8,                         8
04370,        87,        44,        43,                   81,                      6,                         0
01223,        62,        30,        32,                   53,                      3,                         6
04980,        14,         6,         8,                   14,                      0,                         0
01359,         9,         4,         5,                    9,                      0,                         0
01790,        20,        12,         8,                   20,                      0,                         0
01332,        48,        25,        23,                   39,                      0,                         9
06100,       232,       118,       114,                  199,                      3,                        30
09975,        77,        37,        40,                   76,                      1,                         0
06535,       400,       188,       212,                  389,                      4,                         7
00820,       265,       130,       135,                  205,                     22,                        38
03530,        51,        29,        22,                   50,                      0,                         1
01161,        19,         9,        10,                   19,                      0,                         0
02530,        82,        45,        37,                   70,                      2,                        10
05240,       442,       219,       223,                  379,                      7,                        56
00878,        36,        18,        18,                   36,                      0,                         0
04100,        88,        38,        50,                   86,                      2,                         0
02820,       142,        73,        69,                  131,                      5,                         6
01130,        91,        47,        44,                   68,                      0,                        23
01405,       207,       106,       101,                  196,                      7,                         4
02425,       274,       127,       147,                  243,                      3,                        28
07690,       126,        66,        60,                  111,                      3,                        12
07175,        21,        16,         5,                   19,                      1,                         1
05600,         4,         2,         2,                    4,                      0,                         0
07750,       124,        65,        59,                  119,                      0,                         5
03085,       513,       244,       269,                  462,                     11,                        40
07925,        28,        12,        16,                   21,                      5,                         2
01191,        74,        44,        30,                   70,                      0,                         4
00159,        96,        45,        51,                   90,                      0,                         6
07165,       249,       114,       135,                  226,                      3,                        20
03790,        58,        23,        35,                   49,                      8,                         1
04205,        47,        25,        22,                   47,                      0,                         0
00271,        41,        23,        18,                   41,                      0,                         0
08375,       124,        55,        69,                  118,                      0,                         6
00494,       170,        81,        89,                  162,                      1,                         7
00066,       221,        99,       122,                  207,                      7,                         7
04650,       185,        84,       101,                  153,                     13,                        19
01181,        29,        15,        14,                   28,                      0,                         1
07380,        63,        32,        31,                   62,                      0,                         1
01160,        56,        31,        25,                   51,                      1,                         4
02695,        71,        38,        33,                   67,                      3,                         1
02990,       731,       352,       379,                  600,                     21,                       110
00990,        67,        28,        39,                   64,                      2,                         1
03170,       158,        84,        74,                  148,                      1,                         9
07620,        61,        32,        29,                   51,                      2,                         8
03795,       111,        55,        56,                  108,                      0,                         3
00225,       146,        67,        79,                  139,                      2,                         5
00685,        30,        18,        12,                   27,                      0,                         3
00584,       221,       109,       112,                  220,                      0,                         1
08600,        18,         8,        10,                   18,                      0,                         0
06870,       247,       127,       120,                  235,                      5,                         7
05520,        22,        11,        11,                   21,                      0,                         1
06575,        81,        34,        47,                   80,                      1,                         0
03695,       182,        96,        86,                  180,                      1,                         1
00210,        17,         7,        10,                   16,                      1,                         0
00276,        46,        22,        24,                   46,                      0,                         0
03120,        50,        21,        29,                   49,                      0,                         1
06675,        61,        28,        33,                   60,                      0,                         1
02580,       487,       246,       241,                  413,                     12,                        62
00860,        20,         9,        11,                   15,                      4,                         1
07385,        78,        37,        41,                   76,                      0,                         2
00277,        24,        13,        11,                   21,                      1,                         2
07940,        13,         7,         6,                   13,                      0,                         0
07845,       125,        64,        61,                  123,                      2,                         0
01247,         2,         1,         1,                    2,                      0,                         0
05420,        16,         8,         8,                   14,                      2,                         0
04075,        24,        13,        11,                   24,                      0,                         0
09970,         6,         3,         3,                    3,                      2,                         1
00068,       154,        76,        78,                  147,                      3,                         4
01215,        54,        27,        27,                   34,                     19,                         1
00943,        30,        19,        11,                   30,                      0,                         0
04400,       238,       107,       131,                  208,                      8,                        22
00979,         3,         2,         1,                    3,                      0,                         0
08915,         5,         2,         3,                    5,                      0,                         0
00705,        18,         8,        10,                   17,                      1,                         0
07965,         4,         1,         3,                    4,                      0,                         0
02515,       227,       103,       124,                  216,                      2,                         9
09145,        52,        25,        27,                   51,                      1,                         0
05990,        52,        27,        25,                   43,                      9,                         0
05640,        48,        31,        17,                   48,                      0,                         0
02475,        34,        18,        16,                   34,                      0,                         0
07905,        24,        12,        12,                   21,                      1,                         2
02570,        95,        47,        48,                   92,                      3,                         0
02715,        86,        51,        35,                   78,                      2,                         6
08565,       301,       146,       155,                  298,                      0,                         3
02830,       113,        57,        56,                   95,                      1,                        17
00706,         4,         2,         2,                    4,                      0,                         0
09000,        21,        10,        11,                   21,                      0,                         0
04735,       115,        59,        56,                  100,                     15,                         0
06065,        45,        25,        20,                   44,                      0,                         1
05770,        29,        18,        11,                   28,                      0,                         1
01336,         3,         2,         1,                    3,                      0,                         0
07215,       282,       139,       143,                  234,                      8,                        40
00299,        12,         5,         7,                   12,                      0,                         0
00175,        26,        13,        13,                   26,                      0,                         0
05160,        10,         4,         6,                   10,                      0,                         0
00580,        17,         9,         8,                   15,                      2,                         0
00689,        17,         7,        10,                   17,                      0,                         0
00162,       271,       137,       134,                  268,                      0,                         3
08935,         8,         4,         4,                    8,                      0,                         0
07500,         5,         2,         3,                    5,                      0,                         0
00056,        34,        18,        16,                   34,                      0,                         0
00459,       232,       112,       120,                  221,                      3,                         8
08615,        39,        24,        15,                   38,                      1,                         0
06270,        75,        41,        34,                   52,                      0,                        23
03310,       165,        84,        81,                  156,                      4,                         5
00975,        52,        28,        24,                   52,                      0,                         0
00866,         7,         3,         4,                    7,                      0,                         0
06515,         1,         0,         1,                    1,                      0,                         0
00901,        21,        10,        11,                   20,                      1,                         0
01420,        47,        21,        26,                   47,                      0,                         0
03260,        50,        28,        22,                   50,                      0,                         0
01231,        13,         6,         7,                   11,                      0,                         2
04530,       191,       106,        85,                  173,                      3,                        15
00710,        24,        14,        10,                   18,                      4,                         2
05780,        79,        45,        34,                   65,                      2,                        12
08465,       125,        60,        65,                  105,                     11,                         9
05005,        99,        52,        47,                   89,                      2,                         8
07465,        95,        42,        53,                   92,                      1,                         2
01504,         6,         2,         4,                    6,                      0,                         0
05995,        38,        20,        18,                   30,                      0,                         8
00347,         5,         3,         2,                    5,                      0,                         0
05840,        56,        31,        25,                   56,                      0,                         0
00485,        53,        24,        29,                   47,                      0,                         6
00530,        42,        19,        23,                   40,                      0,                         2
00284,         8,         5,         3,                    7,                      0,                         1
02685,        53,        32,        21,                   49,                      3,                         1
00932,         9,         5,         4,                    9,                      0,                         0
00255,       159,        76,        83,                  133,                      7,                        19
02495,       304,       143,       161,                  275,                      6,                        23
06995,         7,         3,         4,                    5,                      0,                         2
00729,        15,         7,         8,                   14,                      1,                         0
00148,         6,         2,         4,                    6,                      0,                         0
05885,        12,         5,         7,                   12,                      0,                         0
08360,        68,        30,        38,                   63,                      1,                         4
06785,       225,       105,       120,                  214,                      0,                        11
06060,        18,         8,        10,                   18,                      0,                         0
00651,         9,         4,         5,                    9,                      0,                         0
00377,         4,         1,         3,                    4,                      0,                         0
06582,         7,         4,         3,                    7,                      0,                         0
00006,        39,        24,        15,                   39,                      0,                         0
05290,        13,         9,         4,                    8,                      0,                         5
01415,        14,         5,         9,                   12,                      2,                         0
04290,        21,        10,        11,                   21,                      0,                         0
00055,        77,        41,        36,                   65,                      1,                        11
00018,        47,        24,        23,                   46,                      1,                         0
09125,        55,        26,        29,                   49,                      0,                         6
00012,         5,         3,         2,                    5,                      0,                         0
02150,         4,         2,         2,                    4,                      0,                         0
01089,         6,         3,         3,                    6,                      0,                         0
02620,        31,        14,        17,                   31,                      0,                         0
07155,        77,        35,        42,                   75,                      0,                         2
07190,        79,        35,        44,                   77,                      0,                         2
03130,       110,        52,        58,                  110,                      0,                         0
00507,        12,         6,         6,                    9,                      0,                         3
01503,        69,        36,        33,                   69,                      0,                         0
00746,         5,         3,         2,                    5,                      0,                         0
00026,        19,        11,         8,                   18,                      0,                         1
00475,        14,         4,        10,                   11,                      0,                         3
01338,         2,         1,         1,                    2,                      0,                         0
01284,         5,         3,         2,                    4,                      0,                         1
01233,        19,         9,        10,                   19,                      0,                         0
00448,         6,         1,         5,                    6,                      0,                         0
06305,        12,         7,         5,                    9,                      0,                         3
07445,        23,        12,        11,                   23,                      0,                         0
04950,         7,         4,         3,                    7,                      0,                         0
03500,       210,        98,       112,                  207,                      2,                         1
00107,        10,         5,         5,                   10,                      0,                         0
06440,        58,        30,        28,                   52,                      0,                         6
01535,        46,        23,        23,                   45,                      0,                         1
00525,        42,        21,        21,                   41,                      0,                         1
07095,        12,         4,         8,                   12,                      0,                         0
06175,         3,         2,         1,                    3,                      0,                         0
00431,         3,         3,         0,                    3,                      0,                         0
00416,         1,         1,         0,                    1,                      0,                         0
09972,         8,         2,         6,                    7,                      1,                         0
05705,       112,        63,        49,                  109,                      0,                         3
00457,         3,         2,         1,                    3,                      0,                         0
09025,        48,        22,        26,                   39,                      0,                         9
07185,        22,        12,        10,                   22,                      0,                         0
01163,        13,        10,         3,                    6,                      0,                         7
03365,       155,        72,        83,                  153,                      0,                         2
07360,        26,        15,        11,                   25,                      0,                         1
07130,         1,         1,         0,                    1,                      0,                         0
00481,        36,        19,        17,                   36,                      0,                         0
05355,        31,        17,        14,                   31,                      0,                         0
00491,        15,         9,         6,                   15,                      0,                         0
00539,         6,         3,         3,                    6,                      0,                         0
00498,        20,         9,        11,                   20,                      0,                         0
00572,        24,        11,        13,                   23,                      1,                         0
00504,         1,         1,         0,                    1,                      0,                         0
00514,        12,         8,         4,                   11,                      0,                         1
00046,        19,         8,        11,                   19,                      0,                         0
00816,        13,         7,         6,                   13,                      0,                         0
02895,        15,         7,         8,                   15,                      0,                         0
08650,         5,         3,         2,                    5,                      0,                         0
07000,        10,         4,         6,                   10,                      0,                         0
01930,        25,        10,        15,                   25,                      0,                         0
00192,         9,         4,         5,                    9,                      0,                         0
00131,         5,         3,         2,                    5,                      0,                         0
06605,        39,        21,        18,                   39,                      0,                         0
08190,         7,         5,         2,                    7,                      0,                         0
02750,        26,        11,        15,                   26,                      0,                         0
00173,        45,        22,        23,                   45,                      0,                         0
00843,        10,         6,         4,                   10,                      0,                         0
00821,         8,         4,         4,                    8,                      0,                         0
04900,        16,         7,         9,                   16,                      0,                         0
00806,         3,         2,         1,                    3,                      0,                         0
05775,       101,        49,        52,                  100,                      0,                         1
01445,        80,        41,        39,                   80,                      0,                         0
05675,        52,        29,        23,                   49,                      0,                         3
01935,        35,        16,        19,                   35,                      0,                         0
00642,        12,         6,         6,                   12,                      0,                         0
01212,         5,         2,         3,                    5,                      0,                         0
00781,         6,         3,         3,                    6,                      0,                         0
00776,         1,         1,         0,                    1,                      0,                         0
08420,        22,        12,        10,                   22,                      0,                         0
00187,         5,         2,         3,                    5,                      0,                         0
00784,         2,         0,         2,                    2,                      0,                         0
01050,        20,         8,        12,                   20,                      0,                         0
03680,         4,         2,         2,                    2,                      2,                         0
06495,        47,        23,        24,                   47,                      0,                         0
08400,         1,         0,         1,                    1,                      0,                         0
03710,        23,        12,        11,                   23,                      0,                         0
00188,         5,         3,         2,                    5,                      0,                         0
00645,        13,         4,         9,                   13,                      0,                         0
00414,        20,         9,        11,                   20,                      0,                         0
02670,         8,         4,         4,                    8,                      0,                         0
07805,        13,         8,         5,                   12,                      1,                         0
07227,        12,         6,         6,                   12,                      0,                         0
01610,         1,         0,         1,                    1,                      0,                         0
00174,         5,         3,         2,                    5,                      0,                         0
01182,         5,         1,         4,                    5,                      0,                         0
00215,        11,         3,         8,                   11,                      0,                         0
09971,        11,         4,         7,                   11,                      0,                         0
01056,         2,         0,         2,                    2,                      0,                         0
00560,        11,         7,         4,                   11,                      0,                         0
01292,         4,         1,         3,                    4,                      0,                         0
00483,         1,         1,         0,                    1,                      0,                         0
03100,         8,         5,         3,                    8,                      0,                         0
03740,         6,         3,         3,                    6,                      0,                         0
00567,         0,         0,         0,                    0,                      0,                         0
01372,         0,         0,         0,                    0,                      0,                         0
01379,         0,         0,         0,                    0,                      0,                         0
01394,         0,         0,         0,                    0,                      0,                         0
00019,         0,         0,         0,                    0,                      0,                         0
00201,         0,         0,         0,                    0,                      0,                         0
06980,         0,         0,         0,                    0,                      0,                         0
00955,         0,         0,         0,                    0,                      0,                         0
00713,         0,         0,         0,                    0,                      0,                         0
00811,         0,         0,         0,                    0,                      0,                         0
00465,         0,         0,         0,                    0,                      0,                         0
06985,         0,         0,         0,                    0,                      0,                         0
00839,         0,         0,         0,                    0,                      0,                         0
00134,         0,         0,         0,                    0,                      0,                         0
00829,         0,         0,         0,                    0,                      0,                         0
00473,         0,         0,         0,                    0,                      0,                         0
01087,        15,         6,         9,                   15,                      0,                         0
08625,       772,       362,       410,                  604,                     95,                        73
03490,        30,        16,        14,                   30,                      0,                         0
08425,        85,        38,        47,                   83,                      0,                         2
04070,       295,       142,       153,                  276,                      5,                        14
09230,       199,       110,        89,                  191,                      6,                         2
07680,       191,        86,       105,                  178,                      2,                        11
01523,        47,        21,        26,                   45,                      0,                         2
09960,       306,       150,       156,                  285,                      4,                        17
00747,        18,         9,         9,                   17,                      0,                         1
09959,        91,        45,        46,                   76,                      7,                         8
02665,        44,        22,        22,                   43,                      1,                         0
06855,        22,        11,        11,                   19,                      2,                         1
06110,       308,       132,       176,                  292,                      7,                         9
01605,        25,        11,        14,                   25,                      0,                         0
01055,        75,        41,        34,                   67,                      8,                         0
00488,        34,        14,        20,                   29,                      5,                         0
00141,        22,        14,         8,                   14,                      7,                         1
04990,        53,        28,        25,                   53,                      0,                         0
07470,       352,       165,       187,                  317,                      3,                        32
09962,       287,       141,       146,                  270,                      6,                        11
08430,       128,        63,        65,                  123,                      0,                         5
06920,       349,       164,       185,                  341,                      0,                         8
07820,        70,        32,        38,                   50,                     14,                         6
02170,       533,       253,       280,                  508,                      8,                        17
01106,        87,        43,        44,                   74,                      7,                         6
02450,       298,       141,       157,                  221,                     54,                        23
04955,       123,        62,        61,                  122,                      0,                         1
01090,       118,        52,        66,                  108,                      6,                         4
03805,        44,        20,        24,                   39,                      3,                         2
07420,       682,       341,       341,                  596,                      9,                        77
01117,        28,        12,        16,                   28,                      0,                         0
00350,       179,        94,        85,                  121,                     55,                         3
00480,       173,        84,        89,                  170,                      1,                         2
02595,        48,        26,        22,                   47,                      0,                         1
04250,        14,         7,         7,                   14,                      0,                         0
00900,       218,       106,       112,                  216,                      1,                         1
08275,        95,        53,        42,                   87,                      6,                         2
02370,       113,        56,        57,                   98,                     10,                         5
07180,        55,        32,        23,                   55,                      0,                         0
07245,        82,        43,        39,                   76,                      3,                         3
07460,        25,        11,        14,                   24,                      0,                         1
04485,        12,         7,         5,                   11,                      1,                         0
00228,        71,        35,        36,                   51,                      6,                        14
07975,        63,        32,        31,                   60,                      0,                         3
02675,       186,        92,        94,                  164,                      3,                        19
05925,        51,        25,        26,                   49,                      1,                         1
00385,        21,        12,         9,                   21,                      0,                         0
02615,        49,        25,        24,                   49,                      0,                         0
00460,        74,        36,        38,                   67,                      5,                         2
01179,        71,        27,        44,                   69,                      0,                         2
04155,        19,        10,         9,                   19,                      0,                         0
05080,        42,        19,        23,                   42,                      0,                         0
00531,        11,         6,         5,                    7,                      3,                         1
09140,        12,         5,         7,                   12,                      0,                         0
06435,        46,        26,        20,                   33,                     12,                         1
06780,         3,         1,         2,                    3,                      0,                         0
00246,         5,         2,         3,                    5,                      0,                         0
07615,        61,        30,        31,                   58,                      1,                         2
00927,        35,        18,        17,                   34,                      1,                         0
00262,        12,         6,         6,                    5,                      7,                         0
00273,        20,        12,         8,                   20,                      0,                         0
03105,       145,        71,        74,                  136,                      4,                         5
01322,        35,        14,        21,                   35,                      0,                         0
00085,        86,        43,        43,                   84,                      0,                         2
07737,       116,        60,        56,                  103,                      2,                        11
07070,        79,        37,        42,                   76,                      2,                         1
09978,        50,        23,        27,                   46,                      1,                         3
03730,        53,        23,        30,                   44,                      1,                         8
00189,        27,        13,        14,                   26,                      0,                         1
02218,       237,       122,       115,                  230,                      1,                         6
01885,        93,        53,        40,                   86,                      7,                         0
00252,        17,         6,        11,                   17,                      0,                         0
01169,        30,        16,        14,                   27,                      0,                         3
00899,        43,        18,        25,                   43,                      0,                         0
04000,        69,        38,        31,                   67,                      0,                         2
04640,       273,       144,       129,                  247,                     14,                        12
00430,        76,        37,        39,                   74,                      1,                         1
00119,        25,         9,        16,                   24,                      0,                         1
01145,        11,         7,         4,                   11,                      0,                         0
03007,       356,       178,       178,                  320,                      4,                        32
03285,       182,        87,        95,                  149,                     19,                        14
01748,        98,        42,        56,                   94,                      0,                         4
00243,         6,         3,         3,                    5,                      0,                         1
04255,       182,        87,        95,                  164,                      5,                        13
02565,         9,         4,         5,                    9,                      0,                         0
01016,        75,        31,        44,                   74,                      0,                         1
00830,        77,        43,        34,                   75,                      1,                         1
01170,        31,        16,        15,                   26,                      0,                         5
08805,        18,         9,         9,                   18,                      0,                         0
04512,        30,        11,        19,                   25,                      1,                         4
06525,        71,        27,        44,                   68,                      0,                         3
05910,       122,        60,        62,                  119,                      2,                         1
00265,       181,        89,        92,                  178,                      0,                         3
06370,        76,        32,        44,                   59,                      3,                        14
04045,        10,         5,         5,                    8,                      0,                         2
05395,       124,        61,        63,                  122,                      0,                         2
00278,         9,         4,         5,                    9,                      0,                         0
03990,        44,        20,        24,                   43,                      0,                         1
04545,        55,        29,        26,                   51,                      0,                         4
02220,       508,       251,       257,                  423,                     15,                        70
01017,        70,        34,        36,                   70,                      0,                         0
00968,        13,         8,         5,                   13,                      0,                         0
05435,       115,        58,        57,                   40,                     74,                         1
03152,         9,         5,         4,                    8,                      0,                         1
01313,        32,        17,        15,                   31,                      0,                         1
05480,        57,        33,        24,                   57,                      0,                         0
04465,        35,        17,        18,                   34,                      1,                         0
04850,       248,       125,       123,                  228,                      5,                        15
01226,        49,        23,        26,                   47,                      2,                         0
04550,       160,        72,        88,                  134,                      3,                        23
04525,         2,         1,         1,                    2,                      0,                         0
00161,       184,        96,        88,                  180,                      3,                         1
00692,         1,         1,         0,                    1,                      0,                         0
06820,        56,        23,        33,                   56,                      0,                         0
03930,        20,         9,        11,                   20,                      0,                         0
01009,         3,         0,         3,                    3,                      0,                         0
00601,        44,        21,        23,                   43,                      1,                         0
01217,        30,        14,        16,                   30,                      0,                         0
01685,       199,        98,       101,                  180,                      2,                        17
00515,        16,         7,         9,                   10,                      6,                         0
07225,        53,        24,        29,                   53,                      0,                         0
06660,        73,        40,        33,                   58,                     11,                         4
01001,        96,        47,        49,                   94,                      2,                         0
00650,       135,        71,        64,                  130,                      5,                         0
05986,       104,        51,        53,                  104,                      0,                         0
05155,         9,         4,         5,                    8,                      0,                         1
07980,        32,        18,        14,                   32,                      0,                         0
00930,        50,        25,        25,                   50,                      0,                         0
05795,        79,        36,        43,                   79,                      0,                         0
03835,        84,        38,        46,                   75,                      4,                         5
06600,       168,        79,        89,                  136,                      5,                        27
03827,        36,        17,        19,                   34,                      2,                         0
00084,        41,        22,        19,                   40,                      1,                         0
04500,       105,        51,        54,                   75,                     17,                        13
00317,        18,         9,         9,                   17,                      1,                         0
00195,        50,        22,        28,                   49,                      0,                         1
08185,        38,        19,        19,                   37,                      0,                         1
06645,        14,         4,        10,                   10,                      4,                         0
07485,        59,        30,        29,                   55,                      0,                         4
00226,        23,        12,        11,                   13,                      5,                         5
00919,        13,         7,         6,                   13,                      0,                         0
03410,        55,        25,        30,                   51,                      3,                         1
01870,        14,         4,        10,                   14,                      0,                         0
01660,       133,        65,        68,                  128,                      2,                         3
05430,        45,        21,        24,                   32,                     12,                         1
09065,       106,        54,        52,                   92,                      4,                        10
00323,         7,         2,         5,                    7,                      0,                         0
09115,       123,        63,        60,                  121,                      2,                         0
00778,         4,         3,         1,                    4,                      0,                         0
00741,        33,        13,        20,                   33,                      0,                         0
02655,        29,        16,        13,                   29,                      0,                         0
00073,        20,        10,        10,                   20,                      0,                         0
04560,        64,        34,        30,                   63,                      0,                         1
01350,        43,        22,        21,                   42,                      1,                         0
03080,       224,       117,       107,                  203,                      3,                        18
00126,        86,        41,        45,                   85,                      0,                         1
07285,        39,        22,        17,                   20,                     15,                         4
01430,         3,         2,         1,                    3,                      0,                         0
00517,        31,        16,        15,                   31,                      0,                         0
03830,        18,         8,        10,                   18,                      0,                         0
00684,        27,        13,        14,                   27,                      0,                         0
00792,        31,        16,        15,                   29,                      1,                         1
04845,        42,        18,        24,                   34,                      1,                         7
00032,        36,        19,        17,                   34,                      1,                         1
00100,         7,         4,         3,                    6,                      0,                         1
07550,       174,        77,        97,                  174,                      0,                         0
06570,        19,         9,        10,                   18,                      1,                         0
02910,        68,        40,        28,                   63,                      3,                         2
05335,        77,        39,        38,                   73,                      1,                         3
07210,        95,        50,        45,                   81,                      2,                        12
04755,       230,       122,       108,                  202,                      4,                        24
00734,         8,         5,         3,                    8,                      0,                         0
03300,        69,        31,        38,                   63,                      4,                         2
08590,        49,        23,        26,                   48,                      1,                         0
00961,         7,         3,         4,                    7,                      0,                         0
00016,        26,        10,        16,                   23,                      0,                         3
00302,        21,        12,         9,                   17,                      1,                         3
00635,        57,        27,        30,                   51,                      2,                         4
07005,        26,         9,        17,                   25,                      0,                         1
02705,         2,         1,         1,                    2,                      0,                         0
00720,        19,         9,        10,                   17,                      0,                         2
08145,       104,        51,        53,                  101,                      3,                         0
03065,        69,        34,        35,                   57,                      0,                        12
00381,         1,         0,         1,                    1,                      0,                         0
07765,         9,         4,         5,                    9,                      0,                         0
03450,        24,        14,        10,                   24,                      0,                         0
00744,         7,         1,         6,                    7,                      0,                         0
01296,        22,        13,         9,                   22,                      0,                         0
01236,         6,         2,         4,                    6,                      0,                         0
01276,         7,         4,         3,                    7,                      0,                         0
01028,         5,         3,         2,                    5,                      0,                         0
00454,         4,         1,         3,                    4,                      0,                         0
00468,        29,        17,        12,                   29,                      0,                         0
00042,        13,         7,         6,                   13,                      0,                         0
07595,       163,        81,        82,                  147,                      2,                        14
05510,         7,         5,         2,                    7,                      0,                         0
07208,        16,         5,        11,                   16,                      0,                         0
08525,        18,         7,        11,                   18,                      0,                         0
01156,         9,         4,         5,                    9,                      0,                         0
07270,        88,        43,        45,                   83,                      4,                         1
06140,        22,        11,        11,                   22,                      0,                         0
08075,         9,         4,         5,                    8,                      1,                         0
04920,        37,        16,        21,                   36,                      1,                         0
05210,        37,        20,        17,                   37,                      0,                         0
00447,         7,         3,         4,                    7,                      0,                         0
09594,        34,        14,        20,                   31,                      0,                         3
01065,        99,        47,        52,                   98,                      1,                         0
01370,        32,        19,        13,                   30,                      0,                         2
05620,        39,        22,        17,                   38,                      0,                         1
01770,        20,         6,        14,                   18,                      1,                         1
08415,        19,         9,        10,                   19,                      0,                         0
00557,        24,        13,        11,                   24,                      0,                         0
00235,        23,        12,        11,                   22,                      0,                         1
02355,       133,        59,        74,                  130,                      0,                         3
04855,        43,        21,        22,                   43,                      0,                         0
00083,        55,        33,        22,                   52,                      2,                         1
01301,         4,         1,         3,                    4,                      0,                         0
07635,         2,         1,         1,                    2,                      0,                         0
00856,         2,         1,         1,                    2,                      0,                         0
06695,        51,        26,        25,                   51,                      0,                         0
00516,        24,        14,        10,                   23,                      0,                         1
00529,        10,         6,         4,                    7,                      0,                         3
01008,        17,        10,         7,                   17,                      0,                         0
00108,        16,         9,         7,                   16,                      0,                         0
01670,         1,         1,         0,                    1,                      0,                         0
02800,        26,        13,        13,                   26,                      0,                         0
01010,        22,         7,        15,                   22,                      0,                         0
00877,         1,         1,         0,                    1,                      0,                         0
03810,        13,         7,         6,                   12,                      0,                         1
08195,        30,        17,        13,                   30,                      0,                         0
00953,         7,         4,         3,                    7,                      0,                         0
00185,        11,         5,         6,                   11,                      0,                         0
00634,        10,         3,         7,                    9,                      0,                         1
08310,        13,         8,         5,                   11,                      2,                         0
00359,        30,        17,        13,                   30,                      0,                         0
00622,         8,         4,         4,                    8,                      0,                         0
08620,         4,         3,         1,                    4,                      0,                         0
00608,         6,         3,         3,                    5,                      0,                         1
03180,        10,         4,         6,                   10,                      0,                         0
05740,         6,         3,         3,                    6,                      0,                         0
06490,        26,        14,        12,                   26,                      0,                         0
00763,         6,         3,         3,                    6,                      0,                         0
00602,        52,        28,        24,                   30,                     16,                         6
02095,        62,        29,        33,                   61,                      0,                         1
00841,         5,         3,         2,                    5,                      0,                         0
00129,        17,         8,         9,                   17,                      0,                         0
07510,        81,        39,        42,                   80,                      1,                         0
05230,        29,        16,        13,                   27,                      1,                         1
04430,        50,        25,        25,                   46,                      0,                         4
00409,        17,        10,         7,                   14,                      2,                         1
07720,         6,         2,         4,                    6,                      0,                         0
07730,         6,         4,         2,                    6,                      0,                         0
05020,         4,         2,         2,                    4,                      0,                         0
00353,        32,        15,        17,                   32,                      0,                         0
08220,         7,         2,         5,                    7,                      0,                         0
00837,         9,         4,         5,                    9,                      0,                         0
04371,        16,         7,         9,                   13,                      0,                         3
08690,        62,        28,        34,                   52,                      5,                         5
05725,        12,         7,         5,                   12,                      0,                         0
00647,        22,         9,        13,                   22,                      0,                         0
03555,         9,         3,         6,                    9,                      0,                         0
05325,        46,        16,        30,                   46,                      0,                         0
07885,         4,         3,         1,                    4,                      0,                         0
03545,       206,       100,       106,                  201,                      2,                         3
00030,        22,        12,        10,                   18,                      0,                         4
00771,         7,         2,         5,                    7,                      0,                         0
06790,        14,         7,         7,                   10,                      4,                         0
08455,        32,        16,        16,                   32,                      0,                         0
05455,        23,        11,        12,                   23,                      0,                         0
01760,        22,        14,         8,                   22,                      0,                         0
00274,         3,         2,         1,                    3,                      0,                         0
00658,         8,         5,         3,                    7,                      1,                         0
06080,        44,        22,        22,                   44,                      0,                         0
05860,        94,        45,        49,                   92,                      0,                         2
00683,        26,        13,        13,                   25,                      0,                         1
06712,        12,         4,         8,                   12,                      0,                         0
02181,         6,         2,         4,                    6,                      0,                         0
01177,        31,        17,        14,                   31,                      0,                         0
03670,        15,         8,         7,                   14,                      0,                         1
05955,        11,         5,         6,                   11,                      0,                         0
01286,         8,         4,         4,                    8,                      0,                         0
06220,         8,         2,         6,                    8,                      0,                         0
05937,         9,         3,         6,                    9,                      0,                         0
00440,         8,         1,         7,                    8,                      0,                         0
09958,         6,         3,         3,                    6,                      0,                         0
01775,         1,         0,         1,                    1,                      0,                         0
01298,         6,         2,         4,                    6,                      0,                         0
01388,         1,         0,         1,                    1,                      0,                         0
01364,         0,         0,         0,                    0,                      0,                         0
00559,         0,         0,         0,                    0,                      0,                         0
00624,         0,         0,         0,                    0,                      0,                         0
00613,         0,         0,         0,                    0,                      0,                         0
00897,         0,         0,         0,                    0,                      0,                         0
00967,         0,         0,         0,                    0,                      0,                         0
02295,         0,         0,         0,                    0,                      0,                         0
00206,         0,         0,         0,                    0,                      0,                         0
01243,         0,         0,         0,                    0,                      0,                         0
00421,         0,         0,         0,                    0,                      0,                         0
01127,         0,         0,         0,                    0,                      0,                         0
00422,         0,         0,         0,                    0,                      0,                         0
00786,         0,         0,         0,                    0,                      0,                         0
00259,         0,         0,         0,                    0,                      0,                         0
00939,         0,         0,         0,                    0,                      0,                         0
06740,         0,         0,         0,                    0,                      0,                         0
03015,       275,       137,       138,                  268,                      5,                         2
05100,        68,        28,        40,                   67,                      1,                         0
05610,      3046,      1502,      1544,                 2970,                     25,                        51
06905,       184,        96,        88,                  168,                      2,                        14
01990,        93,        47,        46,                   87,                      2,                         4
07035,       157,        66,        91,                  143,                     10,                         4
05405,       346,       169,       177,                  284,                     47,                        15
07715,         7,         5,         2,                    7,                      0,                         0
00205,       298,       145,       153,                  286,                      5,                         7
06565,       189,        86,       103,                  184,                      1,                         4
01495,       232,       107,       125,                  226,                      0,                         6
08265,       148,        63,        85,                  144,                      1,                         3
00998,       233,       112,       121,                  228,                      1,                         4
00760,        71,        36,        35,                   71,                      0,                         0
01011,         5,         2,         3,                    5,                      0,                         0
02860,       172,        87,        85,                  150,                      3,                        19
00424,       148,        70,        78,                  143,                      2,                         3
00875,       367,       187,       180,                  317,                      5,                        45
00458,        31,        18,        13,                   31,                      0,                         0
02755,       135,        80,        55,                  130,                      3,                         2
00846,         6,         4,         2,                    6,                      0,                         0
00355,        83,        41,        42,                   59,                     16,                         8
08290,       177,        83,        94,                  151,                     18,                         8
00963,       209,       105,       104,                  189,                     14,                         6
05050,        25,        11,        14,                   21,                      0,                         4
00260,       127,        53,        74,                  114,                      0,                        13
01007,       142,        67,        75,                  134,                      4,                         4
00191,       265,       121,       144,                  259,                      2,                         4
02180,        87,        39,        48,                   87,                      0,                         0
00093,         4,         3,         1,                    4,                      0,                         0
00272,        48,        22,        26,                   46,                      2,                         0
01435,       175,        94,        81,                  171,                      1,                         3
02720,        44,        24,        20,                   44,                      0,                         0
05895,       148,        69,        79,                  146,                      0,                         2
01840,        92,        46,        46,                   59,                      4,                        29
06975,       203,        93,       110,                  184,                      1,                        18
07640,        22,        13,         9,                   22,                      0,                         0
08315,       118,        56,        62,                  113,                      3,                         2
00063,        55,        21,        34,                   54,                      1,                         0
09040,       148,        77,        71,                  136,                      1,                        11
03430,        89,        38,        51,                   73,                     12,                         4
01470,        27,        11,        16,                   23,                      0,                         4
08965,        65,        34,        31,                   58,                      3,                         4
03025,       375,       189,       186,                  330,                      4,                        41
01281,       264,       119,       145,                  241,                      5,                        18
00427,        19,         8,        11,                   19,                      0,                         0
07153,       179,        96,        83,                  157,                      3,                        19
07895,       395,       186,       209,                  352,                     28,                        15
04035,       422,       211,       211,                  410,                      5,                         7
00236,         2,         1,         1,                    2,                      0,                         0
00170,       245,       114,       131,                  201,                      5,                        39
00625,        94,        44,        50,                   84,                      4,                         6
03485,        33,        17,        16,                   30,                      3,                         0
04770,        62,        31,        31,                   54,                      6,                         2
00723,       150,        82,        68,                  149,                      1,                         0
08330,       122,        65,        57,                   94,                      1,                        27
00438,        30,         9,        21,                   30,                      0,                         0
08685,        91,        44,        47,                   82,                      6,                         3
00343,        66,        27,        39,                   57,                      3,                         6
03425,       141,        74,        67,                  128,                      4,                         9
07065,       176,        86,        90,                  164,                      3,                         9
00976,        35,        17,        18,                   28,                      5,                         2
07305,       379,       187,       192,                  359,                      8,                        12
01224,        62,        31,        31,                   58,                      0,                         4
00075,       431,       184,       247,                  423,                      1,                         7
07345,       160,        85,        75,                  152,                      1,                         7
08850,       454,       212,       242,                  403,                     16,                        35
01173,         4,         2,         2,                    4,                      0,                         0
01171,        85,        45,        40,                   84,                      1,                         0
01855,        95,        41,        54,                   79,                      9,                         7
00200,        45,        23,        22,                   45,                      0,                         0
06350,        32,        19,        13,                   32,                      0,                         0
07755,        69,        40,        29,                   57,                      7,                         5
06705,       141,        61,        80,                  101,                     10,                        30
01312,       111,        60,        51,                  106,                      0,                         5
05365,        47,        19,        28,                   47,                      0,                         0
06250,        29,        14,        15,                   25,                      0,                         4
00094,         2,         0,         2,                    2,                      0,                         0
00223,        25,        12,        13,                   24,                      1,                         0
03125,        17,         9,         8,                   17,                      0,                         0
02555,        68,        32,        36,                   65,                      0,                         3
08090,        83,        40,        43,                   68,                      8,                         7
08325,        50,        20,        30,                   44,                      6,                         0
07080,       145,        62,        83,                  130,                      7,                         8
03725,       121,        57,        64,                  105,                      4,                        12
01012,         9,         5,         4,                    9,                      0,                         0
08755,        48,        25,        23,                   41,                      1,                         6
04555,        30,        17,        13,                   28,                      2,                         0
00340,        43,        19,        24,                   43,                      0,                         0
02970,        28,        12,        16,                   28,                      0,                         0
01013,        18,        10,         8,                   18,                      0,                         0
07745,         9,         3,         6,                    9,                      0,                         0
06850,        71,        36,        35,                   62,                      2,                         7
04005,        40,        20,        20,                   39,                      1,                         0
00329,       164,        77,        87,                  160,                      1,                         3
07605,        78,        38,        40,                   69,                      0,                         9
01860,        40,        20,        20,                   40,                      0,                         0
05140,        50,        28,        22,                   46,                      2,                         2
00144,        11,         7,         4,                   11,                      0,                         0
09220,        41,        22,        19,                   41,                      0,                         0
01256,         6,         2,         4,                    6,                      0,                         0
04090,        59,        26,        33,                   56,                      1,                         2
01031,        54,        24,        30,                   54,                      0,                         0
01675,        36,        22,        14,                   35,                      1,                         0
04760,       353,       174,       179,                  284,                     39,                        30
05260,        94,        43,        51,                   94,                      0,                         0
00306,        14,         7,         7,                   14,                      0,                         0
08890,        91,        47,        44,                   85,                      4,                         2
03940,       169,        82,        87,                  165,                      1,                         3
00455,        50,        26,        24,                   49,                      0,                         1
00116,        64,        32,        32,                   63,                      1,                         0
05035,       103,        57,        46,                  101,                      0,                         2
00432,        21,        10,        11,                   20,                      1,                         0
04605,        19,         9,        10,                   16,                      1,                         2
06165,        44,        15,        29,                   44,                      0,                         0
03350,        91,        46,        45,                   86,                      3,                         2
02440,         5,         2,         3,                    5,                      0,                         0
00045,        43,        19,        24,                   32,                      0,                        11
03380,       219,       115,       104,                  187,                     26,                         6
09210,        59,        34,        25,                   59,                      0,                         0
01110,        14,         7,         7,                   14,                      0,                         0
02455,        24,        11,        13,                   23,                      1,                         0
00615,       101,        44,        57,                   82,                     17,                         2
08205,       532,       264,       268,                  483,                      9,                        40
00694,        10,         5,         5,                   10,                      0,                         0
00130,       103,        45,        58,                   95,                      2,                         6
02160,        27,        15,        12,                   23,                      3,                         1
08570,        55,        26,        29,                   51,                      0,                         4
01830,        32,        15,        17,                   31,                      1,                         0
00156,         4,         1,         3,                    4,                      0,                         0
03665,        46,        24,        22,                   45,                      1,                         0
02000,        51,        25,        26,                   47,                      4,                         0
01875,        13,         9,         4,                   13,                      0,                         0
06105,        58,        27,        31,                   58,                      0,                         0
05380,        90,        42,        48,                   90,                      0,                         0
08760,        79,        42,        37,                   73,                      0,                         6
07960,       171,        82,        89,                  159,                      8,                         4
01309,        28,        13,        15,                   28,                      0,                         0
02680,        19,         8,        11,                   19,                      0,                         0
01363,        21,        11,        10,                   20,                      1,                         0
04730,        23,         8,        15,                   22,                      0,                         1
00004,        21,        12,         9,                   21,                      0,                         0
00316,        17,         9,         8,                   14,                      3,                         0
01316,        22,        12,        10,                    8,                      0,                        14
06085,        57,        31,        26,                   48,                      7,                         2
04475,        66,        30,        36,                   60,                      0,                         6
03755,        62,        33,        29,                   55,                      5,                         2
05145,        45,        24,        21,                   27,                     16,                         2
01635,        95,        47,        48,                   95,                      0,                         0
03470,       344,       170,       174,                  311,                      1,                        32
07045,       137,        67,        70,                  122,                      0,                        15
00314,        10,         6,         4,                   10,                      0,                         0
04055,       119,        53,        66,                  108,                     10,                         1
05975,        89,        41,        48,                   67,                      0,                        22
01092,        14,        10,         4,                   12,                      0,                         2
02872,        16,         9,         7,                   14,                      0,                         2
00149,        23,        12,        11,                   23,                      0,                         0
07790,        78,        39,        39,                   63,                      0,                        15
06415,         9,         3,         6,                    7,                      2,                         0
08050,       119,        55,        64,                  116,                      0,                         3
07835,       251,       137,       114,                  237,                      6,                         8
00324,        11,         8,         3,                   11,                      0,                         0
00330,        78,        40,        38,                   62,                      1,                        15
03465,       125,        66,        59,                  112,                      1,                        12
00966,         4,         1,         3,                    4,                      0,                         0
00957,         3,         1,         2,                    3,                      0,                         0
05400,       192,        87,       105,                  173,                      0,                        19
08250,         9,         6,         3,                    9,                      0,                         0
01401,         1,         1,         0,                    1,                      0,                         0
04825,        22,         9,        13,                   21,                      1,                         0
04245,        21,         9,        12,                   11,                      5,                         5
05375,        22,        10,        12,                   22,                      0,                         0
04265,        15,         8,         7,                   14,                      0,                         1
01227,        17,         8,         9,                   13,                      0,                         4
02420,        10,         2,         8,                   10,                      0,                         0
00305,        19,         8,        11,                   19,                      0,                         0
03800,        33,        16,        17,                   27,                      0,                         6
09225,        26,        10,        16,                   23,                      0,                         3
08955,        53,        23,        30,                   50,                      2,                         1
07090,        84,        51,        33,                   78,                      1,                         5
01218,         8,         3,         5,                    8,                      0,                         0
00058,        18,         6,        12,                   18,                      0,                         0
00139,        47,        23,        24,                   44,                      0,                         3
06395,        81,        39,        42,                   69,                      0,                        12
01992,       118,        65,        53,                  115,                      1,                         2
02365,        55,        23,        32,                   47,                      3,                         5
00388,        23,        13,        10,                   22,                      1,                         0
08350,        19,        10,         9,                   19,                      0,                         0
01040,        29,        16,        13,                   23,                      0,                         6
01550,        60,        31,        29,                   60,                      0,                         0
04995,        80,        42,        38,                   66,                      3,                        11
02630,        14,         9,         5,                   14,                      0,                         0
00079,        77,        36,        41,                   55,                      7,                        15
07670,       213,       107,       106,                  194,                      4,                        15
01025,         8,         4,         4,                    8,                      0,                         0
00081,         5,         4,         1,                    5,                      0,                         0
01174,         4,         3,         1,                    4,                      0,                         0
08735,        51,        23,        28,                   44,                      2,                         5
00719,         4,         2,         2,                    4,                      0,                         0
04975,        18,         7,        11,                   15,                      0,                         3
00859,         4,         2,         2,                    4,                      0,                         0
08992,        76,        37,        39,                   75,                      0,                         1
00153,        22,        12,        10,                   19,                      2,                         1
00007,         8,         6,         2,                    8,                      0,                         0
03600,        30,        15,        15,                   28,                      2,                         0
00397,         3,         2,         1,                    3,                      0,                         0
01238,        14,         8,         6,                   14,                      0,                         0
01259,        17,        10,         7,                   17,                      0,                         0
00059,        15,         9,         6,                   15,                      0,                         0
03360,        63,        30,        33,                   43,                      0,                        20
07240,        51,        24,        27,                   50,                      0,                         1
05270,        39,        21,        18,                   32,                      0,                         7
01940,        33,        18,        15,                   33,                      0,                         0
00845,       107,        50,        57,                   98,                      6,                         3
09060,        33,        14,        19,                   33,                      0,                         0
00462,         2,         1,         1,                    2,                      0,                         0
09999,         1,         1,         0,                    0,                      1,                         0
03140,        47,        21,        26,                   45,                      0,                         2
07725,        20,        12,         8,                   18,                      1,                         1
00434,         5,         3,         2,                    5,                      0,                         0
06715,        68,        30,        38,                   60,                      4,                         4
00227,         7,         5,         2,                    7,                      0,                         0
08665,       110,        52,        58,                  109,                      0,                         1
05200,        87,        42,        45,                   74,                      2,                        11
04480,         6,         4,         2,                    6,                      0,                         0
05855,        25,        13,        12,                   25,                      0,                         0
00703,         6,         4,         2,                    6,                      0,                         0
01291,         6,         3,         3,                    6,                      0,                         0
00750,        12,         7,         5,                   12,                      0,                         0
00573,         9,         6,         3,                    9,                      0,                         0
09070,        11,         7,         4,                   11,                      0,                         0
08635,        12,         6,         6,                    9,                      0,                         3
00629,         2,         1,         1,                    2,                      0,                         0
05830,        25,        13,        12,                   25,                      0,                         0
00209,         5,         1,         4,                    5,                      0,                         0
00526,         5,         4,         1,                    5,                      0,                         0
00496,         5,         3,         2,                    5,                      0,                         0
06005,        24,        12,        12,                   24,                      0,                         0
01248,         7,         5,         2,                    7,                      0,                         0
03540,        11,         7,         4,                   11,                      0,                         0
00380,        24,        14,        10,                   22,                      0,                         2
00631,         7,         5,         2,                    7,                      0,                         0
01945,         1,         1,         0,                    1,                      0,                         0
07700,        16,        11,         5,                   16,                      0,                         0
00091,         7,         2,         5,                    7,                      0,                         0
00836,         3,         2,         1,                    3,                      0,                         0
01193,         4,         2,         2,                    4,                      0,                         0
00088,         7,         2,         5,                    7,                      0,                         0
08010,        18,         8,        10,                   18,                      0,                         0
00638,         9,         3,         6,                    9,                      0,                         0
08870,         9,         5,         4,                    9,                      0,                         0
02955,        66,        32,        34,                   66,                      0,                         0
00594,         6,         3,         3,                    6,                      0,                         0
00838,        23,        16,         7,                   23,                      0,                         0
00194,         4,         4,         0,                    4,                      0,                         0
03315,        41,        23,        18,                   40,                      1,                         0
00117,         7,         3,         4,                    7,                      0,                         0
01710,        84,        46,        38,                   83,                      0,                         1
00640,        29,        13,        16,                   29,                      0,                         0
00561,         6,         2,         4,                    6,                      0,                         0
07875,        18,        12,         6,                   18,                      0,                         0
03235,        24,        11,        13,                   24,                      0,                         0
05015,        30,        14,        16,                   30,                      0,                         0
00363,        23,         9,        14,                   23,                      0,                         0
01905,         9,         4,         5,                    9,                      0,                         0
01265,        24,        12,        12,                   24,                      0,                         0
02205,        19,        10,         9,                   19,                      0,                         0
00168,        83,        41,        42,                   83,                      0,                         0
03550,         8,         6,         2,                    8,                      0,                         0
03010,        19,        13,         6,                   19,                      0,                         0
04625,        15,         8,         7,                   15,                      0,                         0
00788,         3,         1,         2,                    3,                      0,                         0
09592,         5,         3,         2,                    5,                      0,                         0
01530,        19,        11,         8,                   19,                      0,                         0
05025,        10,         4,         6,                   10,                      0,                         0
02460,        34,        14,        20,                   33,                      1,                         0
05785,         5,         2,         3,                    5,                      0,                         0
03455,        11,         7,         4,                    9,                      2,                         0
02375,         5,         1,         4,                    5,                      0,                         0
07170,         3,         1,         2,                    3,                      0,                         0
01410,        27,        14,        13,                   27,                      0,                         0
06805,         5,         1,         4,                    5,                      0,                         0
00664,         7,         3,         4,                    7,                      0,                         0
02445,        75,        43,        32,                   73,                      0,                         2
06710,         4,         2,         2,                    4,                      0,                         0
01306,        26,        12,        14,                   22,                      0,                         4
01555,         6,         3,         3,                    5,                      1,                         0
00555,         1,         0,         1,                    1,                      0,                         0
08115,         3,         3,         0,                    3,                      0,                         0
00861,         3,         2,         1,                    3,                      0,                         0
01043,         2,         1,         1,                    2,                      0,                         0
01303,        13,         5,         8,                   10,                      0,                         3
00248,         6,         4,         2,                    5,                      0,                         1
03760,         1,         1,         0,                    0,                      0,                         1
01371,         1,         1,         0,                    1,                      0,                         0
01346,         0,         0,         0,                    0,                      0,                         0
00873,         0,         0,         0,                    0,                      0,                         0
00294,         0,         0,         0,                    0,                      0,                         0
00241,         0,         0,         0,                    0,                      0,                         0
00660,         0,         0,         0,                    0,                      0,                         0
00964,         0,         0,         0,                    0,                      0,                         0
00549,         0,         0,         0,                    0,                      0,                         0
01187,         0,         0,         0,                    0,                      0,                         0
00929,         0,         0,         0,                    0,                      0,                         0
00644,         0,         0,         0,                    0,                      0,                         0
01206,         0,         0,         0,                    0,                      0,                         0
00942,         0,         0,         0,                    0,                      0,                         0
00693,         0,         0,         0,                    0,                      0,                         0
00626,         0,         0,         0,                    0,                      0,                         0
00497,         0,         0,         0,                    0,                      0,                         0
01580,         0,         0,         0,                    0,                      0,                         0
00988,         0,         0,         0,                    0,                      0,                         0
01501,         0,         0,         0,                    0,                      0,                         0
00436,         0,         0,         0,                    0,                      0,                         0
08840,       158,       100,        58,                  130,                      4,                        24
00233,        20,         6,        14,                   20,                      0,                         0
01750,        89,        43,        46,                   74,                      0,                        15
05095,        53,        27,        26,                   52,                      1,                         0
00135,       275,       115,       160,                  252,                     11,                        12
00863,        27,        10,        17,                   27,                      0,                         0
00267,       132,        61,        71,                  126,                      0,                         6
03480,       321,       151,       170,                  260,                     34,                        27
04420,       579,       271,       308,                  543,                     18,                        18
01455,       107,        45,        62,                   99,                      5,                         3
00300,        62,        29,        33,                   60,                      0,                         2
00104,        41,        18,        23,                   40,                      0,                         1
09100,       222,       100,       122,                  190,                     19,                        13
06355,       239,       111,       128,                  221,                     13,                         5
00231,       846,       400,       446,                  713,                     53,                        80
01335,        60,        29,        31,                   54,                      2,                         4
03190,       240,       113,       127,                  239,                      0,                         1
01162,       112,        39,        73,                  111,                      1,                         0
06170,       506,       241,       265,                  465,                      8,                        33
07265,       229,       115,       114,                  207,                     13,                         9
02635,       355,       167,       188,                  323,                     20,                        12
00394,        48,        24,        24,                   47,                      0,                         1
00916,        53,        23,        30,                   49,                      1,                         3
07115,       487,       249,       238,                  450,                     11,                        26
09968,       511,       223,       288,                  495,                      4,                        12
03440,       162,        74,        88,                  144,                      7,                        11
08240,       246,       122,       124,                  219,                      3,                        24
00247,        90,        47,        43,                   90,                      0,                         0
01845,      1375,       682,       693,                 1169,                     53,                       153
00064,       151,        76,        75,                  150,                      0,                         1
01400,        63,        30,        33,                   61,                      0,                         2
00074,        59,        29,        30,                   51,                      4,                         4
04050,        80,        44,        36,                   78,                      1,                         1
07575,       164,        93,        71,                  150,                      1,                        13
06160,        53,        22,        31,                   48,                      5,                         0
02560,       275,       125,       150,                  249,                     17,                         9
08480,       166,        85,        81,                  159,                      4,                         3
02925,       136,        60,        76,                  124,                      3,                         9
00847,        49,        24,        25,                   46,                      0,                         3
06635,        53,        23,        30,                   32,                     20,                         1
05265,        29,        12,        17,                   26,                      0,                         3
01365,       584,       289,       295,                  455,                     16,                       113
01925,       350,       190,       160,                  338,                      3,                         9
00879,        46,        20,        26,                   45,                      1,                         0
03290,       300,       135,       165,                  264,                      5,                        31
03155,        42,        16,        26,                   41,                      1,                         0
02025,        26,         9,        17,                   22,                      1,                         3
09090,        28,        18,        10,                   27,                      1,                         0
09602,        35,        19,        16,                   34,                      0,                         1
01264,        44,        17,        27,                   39,                      2,                         3
00982,         5,         3,         2,                    5,                      0,                         0
04277,        18,        15,         3,                   15,                      1,                         2
02525,        39,        19,        20,                   37,                      1,                         1
04185,       150,        85,        65,                  140,                      1,                         9
01060,       197,       103,        94,                  195,                      0,                         2
01164,        35,        19,        16,                   33,                      0,                         2
01293,        19,         8,        11,                   19,                      0,                         0
05570,        25,        12,        13,                   25,                      0,                         0
03325,        77,        34,        43,                   76,                      0,                         1
00774,        58,        27,        31,                   57,                      1,                         0
00067,       282,       138,       144,                  275,                      2,                         5
00125,        50,        21,        29,                   45,                      3,                         2
05075,        61,        29,        32,                   61,                      0,                         0
02735,        46,        23,        23,                   37,                      9,                         0
00041,       128,        63,        65,                  115,                      3,                        10
02825,       176,        87,        89,                  164,                      1,                        11
00444,        70,        30,        40,                   63,                      3,                         4
06210,        78,        40,        38,                   71,                      4,                         3
01615,       183,        88,        95,                  163,                      3,                        17
06725,        50,        23,        27,                   35,                      0,                        15
00655,        42,        21,        21,                   41,                      0,                         1
01105,        95,        49,        46,                   93,                      0,                         2
08055,        47,        20,        27,                   44,                      1,                         2
07370,       284,       128,       156,                  262,                      2,                        20
04830,        48,        25,        23,                   37,                      9,                         2
08005,        32,        17,        15,                   32,                      0,                         0
00520,        60,        28,        32,                   53,                      6,                         1
04235,       148,        74,        74,                  139,                      3,                         6
06895,        50,        24,        26,                   48,                      2,                         0
00165,        44,        26,        18,                   44,                      0,                         0
04635,       505,       254,       251,                  267,                    177,                        61
05040,        12,        10,         2,                   10,                      2,                         0
02310,       434,       221,       213,                  429,                      1,                         4
08470,         2,         1,         1,                    2,                      0,                         0
04655,       238,       116,       122,                  237,                      0,                         1
01950,        55,        23,        32,                   55,                      0,                         0
01890,        41,        25,        16,                   41,                      0,                         0
09190,        71,        30,        41,                   70,                      0,                         1
00506,       149,        79,        70,                  143,                      0,                         6
02880,        10,         5,         5,                   10,                      0,                         0
00293,        11,         5,         6,                   11,                      0,                         0
03765,       261,       124,       137,                  225,                      9,                        27
00805,        59,        31,        28,                   52,                      6,                         1
05320,        23,        10,        13,                   22,                      0,                         1
08645,        27,        13,        14,                   24,                      0,                         3
04160,        22,         7,        15,                   19,                      3,                         0
01144,        51,        22,        29,                   49,                      0,                         2
03445,        69,        35,        34,                   40,                     28,                         1
01245,        85,        40,        45,                   85,                      0,                         0
07300,        61,        27,        34,                   57,                      0,                         4
00245,       129,        55,        74,                  118,                      4,                         7
01695,        47,        23,        24,                   47,                      0,                         0
04885,        56,        28,        28,                   54,                      0,                         2
00956,        33,        17,        16,                   33,                      0,                         0
00289,         6,         3,         3,                    6,                      0,                         0
04615,       177,        83,        94,                  158,                      6,                        13
07525,        61,        27,        34,                   61,                      0,                         0
05920,        45,        23,        22,                   45,                      0,                         0
00665,         1,         0,         1,                    1,                      0,                         0
03370,        12,         6,         6,                   12,                      0,                         0
03655,         3,         2,         1,                    3,                      0,                         0
05190,       168,        78,        90,                  165,                      3,                         0
09974,         8,         5,         3,                    8,                      0,                         0
00327,        19,        10,         9,                   19,                      0,                         0
00366,        28,        16,        12,                   28,                      0,                         0
06205,         1,         1,         0,                    1,                      0,                         0
08040,       136,        77,        59,                  106,                      2,                        28
06320,        98,        49,        49,                   97,                      0,                         1
04680,        87,        41,        46,                   73,                      6,                         8
01318,        19,         8,        11,                   19,                      0,                         0
08880,        41,        25,        16,                   38,                      1,                         2
03935,         6,         3,         3,                    6,                      0,                         0
00328,        14,         7,         7,                   14,                      0,                         0
00825,        19,         7,        12,                   18,                      0,                         1
07990,        24,        12,        12,                   23,                      0,                         1
00477,       384,       190,       194,                  369,                      2,                        13
06075,       240,       142,        98,                  212,                      5,                        23
03225,        84,        49,        35,                   65,                      0,                        19
00850,        31,        15,        16,                   20,                      4,                         7
03920,        39,        23,        16,                   39,                      0,                         0
01168,        26,        12,        14,                   26,                      0,                         0
05625,         4,         1,         3,                    3,                      0,                         1
04595,        25,        13,        12,                   25,                      0,                         0
00547,         6,         3,         3,                    6,                      0,                         0
08950,       264,       122,       142,                  223,                      2,                        39
00797,        10,         7,         3,                   10,                      0,                         0
00445,        49,        24,        25,                   39,                      1,                         9
05350,       120,        66,        54,                  114,                      0,                         6
00222,         8,         5,         3,                    8,                      0,                         0
00229,        15,         8,         7,                   13,                      0,                         2
02100,        21,        11,        10,                   21,                      0,                         0
00326,         4,         3,         1,                    4,                      0,                         0
00716,        82,        40,        42,                   80,                      2,                         0
01362,         8,         3,         5,                    8,                      0,                         0
00184,         8,         4,         4,                    8,                      0,                         0
00346,       146,        77,        69,                  143,                      0,                         3
04126,        46,        20,        26,                   45,                      0,                         1
00610,        37,        18,        19,                   35,                      1,                         1
00666,        41,        23,        18,                   41,                      0,                         0
09130,       126,        54,        72,                  110,                      4,                        12
00232,        25,        10,        15,                   23,                      0,                         2
00420,        66,        29,        37,                   55,                      1,                        10
03230,         7,         4,         3,                    7,                      0,                         0
03915,        52,        22,        30,                   50,                      0,                         2
06775,         6,         3,         3,                    6,                      0,                         0
07440,         5,         2,         3,                    5,                      0,                         0
03590,         8,         5,         3,                    7,                      0,                         1
00959,         7,         3,         4,                    7,                      0,                         0
01485,        39,        20,        19,                   39,                      0,                         0
07105,        79,        39,        40,                   73,                      1,                         5
00105,        40,        22,        18,                   40,                      0,                         0
06655,       101,        50,        51,                   95,                      0,                         6
05175,        79,        36,        43,                   78,                      0,                         1
02320,       283,       159,       124,                  265,                     14,                         4
05385,        10,         4,         6,                    9,                      0,                         1
02865,        21,         9,        12,                   19,                      0,                         2
06915,        97,        55,        42,                   81,                      2,                        14
05470,        43,        17,        26,                   34,                      8,                         1
00379,         2,         2,         0,                    2,                      0,                         0
04580,        54,        27,        27,                   47,                      3,                         4
03650,        25,        12,        13,                   25,                      0,                         0
06795,       175,        85,        90,                  160,                      0,                        15
01151,        65,        35,        30,                   65,                      0,                         0
00320,        25,        18,         7,                   24,                      0,                         1
00749,        30,        13,        17,                   30,                      0,                         0
05800,        73,        36,        37,                   72,                      0,                         1
04505,        38,        15,        23,                   36,                      0,                         2
00319,         8,         4,         4,                    8,                      0,                         0
05560,        37,        26,        11,                   25,                      6,                         6
01219,         6,         4,         2,                    6,                      0,                         0
00357,        55,        31,        24,                   54,                      0,                         1
01341,         2,         1,         1,                    2,                      0,                         0
03615,        28,        14,        14,                   22,                      5,                         1
00478,         3,         2,         1,                    3,                      0,                         0
03675,        18,        11,         7,                   18,                      0,                         0
01343,        10,         4,         6,                   10,                      0,                         0
01139,         7,         4,         3,                    7,                      0,                         0
05390,        23,        13,        10,                   21,                      0,                         2
04065,        18,        11,         7,                   18,                      0,                         0
07235,        69,        36,        33,                   54,                      0,                        15
06925,        45,        26,        19,                   36,                      2,                         7
01525,        17,         8,         9,                   17,                      0,                         0
05566,         3,         2,         1,                    3,                      0,                         0
00924,        29,        16,        13,                   29,                      0,                         0
00636,         5,         3,         2,                    5,                      0,                         0
00864,        11,         7,         4,                   11,                      0,                         0
00495,        19,         9,        10,                   19,                      0,                         0
00702,         5,         1,         4,                    5,                      0,                         0
01366,         8,         4,         4,                    8,                      0,                         0
00040,       168,        84,        84,                  165,                      3,                         0
05360,        18,         9,         9,                   18,                      0,                         0
00486,         2,         1,         1,                    2,                      0,                         0
08390,         5,         5,         0,                    4,                      0,                         1
00701,         2,         2,         0,                    2,                      0,                         0
07230,        40,        20,        20,                   35,                      0,                         5
07475,        62,        32,        30,                   55,                      4,                         3
00503,        24,        12,        12,                   24,                      0,                         0
01188,        12,         8,         4,                   12,                      0,                         0
00536,         7,         4,         3,                    7,                      0,                         0
00697,        43,        20,        23,                   43,                      0,                         0
00686,         5,         3,         2,                    4,                      1,                         0
00914,         3,         1,         2,                    3,                      0,                         0
01205,         9,         5,         4,                    9,                      0,                         0
02480,        17,         7,        10,                   17,                      0,                         0
00575,        20,        13,         7,                   20,                      0,                         0
01208,         7,         4,         3,                    7,                      0,                         0
00604,        27,        11,        16,                   27,                      0,                         0
00611,         5,         1,         4,                    5,                      0,                         0
00616,         9,         5,         4,                    9,                      0,                         0
00565,        10,         5,         5,                    9,                      1,                         0
00612,         8,         4,         4,                    8,                      0,                         0
00699,         4,         3,         1,                    4,                      0,                         0
00050,        39,        20,        19,                   38,                      0,                         1
07695,         6,         3,         3,                    6,                      0,                         0
02940,        12,         6,         6,                   12,                      0,                         0
01450,        24,        14,        10,                   22,                      1,                         1
04375,        34,        18,        16,                   34,                      0,                         0
08255,       122,        56,        66,                  118,                      4,                         0
04170,        33,        17,        16,                   33,                      0,                         0
07840,        31,        16,        15,                   31,                      0,                         0
00521,        10,         7,         3,                   10,                      0,                         0
00513,         2,         1,         1,                    2,                      0,                         0
00627,         7,         3,         4,                    7,                      0,                         0
05540,         7,         2,         5,                    7,                      0,                         0
06500,        81,        36,        45,                   81,                      0,                         0
00764,        12,         5,         7,                   12,                      0,                         0
00639,        10,         4,         6,                   10,                      0,                         0
07110,         5,         2,         3,                    5,                      0,                         0
01895,        26,        12,        14,                   26,                      0,                         0
00803,        11,         4,         7,                   11,                      0,                         0
06700,       114,        53,        61,                  108,                      3,                         3
01705,        80,        37,        43,                   79,                      1,                         0
05875,        47,        21,        26,                   47,                      0,                         0
02710,         4,         2,         2,                    4,                      0,                         0
02600,        18,        10,         8,                   18,                      0,                         0
05440,        28,        11,        17,                   14,                     13,                         1
00198,         8,         4,         4,                    8,                      0,                         0
00801,         9,         4,         5,                    9,                      0,                         0
00818,         4,         2,         2,                    4,                      0,                         0
06880,         1,         0,         1,                    1,                      0,                         0
04780,         2,         0,         2,                    2,                      0,                         0
00680,        59,        28,        31,                   59,                      0,                         0
00181,         3,         1,         2,                    3,                      0,                         0
03575,        50,        24,        26,                   50,                      0,                         0
00656,         5,         1,         4,                    5,                      0,                         0
00619,        25,        13,        12,                   24,                      1,                         0
06340,        12,         7,         5,                   12,                      0,                         0
06050,         5,         2,         3,                    5,                      0,                         0
07825,        39,        21,        18,                   37,                      2,                         0
00103,        19,         8,        11,                   19,                      0,                         0
00885,         4,         2,         2,                    4,                      0,                         0
00667,         2,         1,         1,                    2,                      0,                         0
04367,         9,         3,         6,                    9,                      0,                         0
00408,         4,         1,         3,                    4,                      0,                         0
03542,         4,         1,         3,                    4,                      0,                         0
03275,         3,         2,         1,                    3,                      0,                         0
00915,         7,         4,         3,                    7,                      0,                         0
09075,         4,         2,         2,                    4,                      0,                         0
01027,         4,         3,         1,                    0,                      0,                         4
01282,         6,         2,         4,                    5,                      0,                         1
01267,         2,         1,         1,                    2,                      0,                         0
01279,         5,         2,         3,                    5,                      0,                         0
01367,         4,         2,         2,                    4,                      0,                         0
01194,         0,         0,         0,                    0,                      0,                         0
00958,         0,         0,         0,                    0,                      0,                         0
00024,         0,         0,         0,                    0,                      0,                         0
01373,         0,         0,         0,                    0,                      0,                         0
00090,         0,         0,         0,                    0,                      0,                         0
00383,         0,         0,         0,                    0,                      0,                         0
00607,         0,         0,         0,                    0,                      0,                         0
00400,         0,         0,         0,                    0,                      0,                         0
01600,         0,         0,         0,                    0,                      0,                         0
00384,         0,         0,         0,                    0,                      0,                         0
04785,         0,         0,         0,                    0,                      0,                         0
06365,         0,         0,         0,                    0,                      0,                         0
01221,         0,         0,         0,                    0,                      0,                         0
03250,         0,         0,         0,                    0,                      0,                         0
00717,         0,         0,         0,                    0,                      0,                         0
01081,         0,         0,         0,                    0,                      0,                         0
01358,         0,         0,         0,                    0,                      0,                         0
03581,         0,         0,         0,                    0,                      0,                         0
